SendRate(Mb/s),ReceiveRate(Mb/s),SendPackets,Send Loss,Recv Loss,RTT(ms),CWnd,OutstandingData,FlowWindow,Retrans,PktSndPeriod(us),SendACK,SendNAK,RecvACK,RecvNAK,EstimatedBandwidth(Mb/s),Retrans_Total, NAK_TotalSent,Total Send Loss,Total Recv Loss
0.0115787,0,26,1,0,106.851,41848,3,8189,1,52023.4,0,0,5,1,0.21728,1,0,1,0
0.0170141,0,38,0,0,193.773,2610,11,8190,0,17175.6,0,0,26,0,0.442176,1,0,1,0
0.0456638,0,102,0,0,208.364,37,29,8188,0,7031.25,0,0,57,0,0.453376,1,0,1,0
0.0828406,0,185,0,0,205.163,43,43,8189,0,4069.64,0,0,69,0,0.404992,1,0,1,0
0.0951491,0,213,0,0,205.106,44,44,8188,0,2851.26,0,0,71,0,0.372736,1,0,1,0
0.0993959,0,222,0,0,206.029,46,46,8189,0,2246.07,0,0,67,0,0.581952,1,0,1,0
1.70162,0,3800,0,0,207.759,189925,2958,8133,0,42.7135,0,0,66,0,160.422,1,0,1,0
4.7616,0,10632,4739,0,207.028,209741,8171,8171,4739,155,0,0,10,86,202.248,4740,0,4740,0
3.46525,0,7739,8171,0,204.216,197949,3528,8154,7739,88.876,0,0,37,0,296.921,12479,0,12911,0
3.0875,0,6895,8773,0,204.216,197949,8154,8154,2269,144,0,0,0,25,296.921,14748,0,21684,0
6.18294,0,13808,2114,0,204.824,186247,6856,8098,4626,44,0,0,27,28,277.411,19374,0,23798,0
3.6091,0,8061,11165,0,205.232,206634,6942,7972,6819,78.0958,0,0,9,27,259.478,26193,0,34963,0
2.93309,0,6550,8649,0,205.232,206634,8191,8191,5301,99,0,0,0,7,259.478,31494,0,43612,0
4.87268,0,10882,7896,0,204.945,198940,7896,8191,8740,114,0,0,9,4,273.534,40234,0,51508,0
4.07998,0,9109,136,0,204.833,172768,5640,8191,5261,134,0,0,6,18,276.407,45495,0,51644,0
3.36215,0,7508,8205,0,205.064,195510,1886,8053,1671,106.239,0,0,16,1,298.42,47166,0,59849,0
5.75388,0,12850,4508,0,204.965,184758,7969,7969,4508,159,0,0,18,62,246.983,51674,0,64357,0
2.81934,0,6298,7969,0,205.411,211544,3575,8108,6298,101.119,0,0,26,0,288.316,57972,0,72326,0
4.12794,0,9232,580,0,204.909,162474,1943,8191,2251,102.676,0,0,43,24,260.674,60223,0,72906,0
4.00267,0,8953,770,0,204.943,187998,8191,8191,770,125,0,0,17,42,259.61,60993,0,73676,0
4.01879,0,8983,8241,0,205.48,200167,3699,8191,3735,122,0,0,20,5,259.755,64728,0,81917,0
3.3845,0,7557,7893,0,205.589,206619,569,569,1830,138,0,0,3,13,268.941,66558,0,89810,0
6.81378,0,15216,4775,0,205.497,188941,8060,8060,4775,51,0,0,27,53,255.267,71333,0,94585,0
4.31447,0,9634,8535,0,205.122,198686,8170,8170,8535,63.4857,0,0,7,3,273.357,79868,0,103120,0
2.76961,0,6184,8595,0,204.814,207457,6303,8169,6184,86.0617,0,0,6,23,265.086,86052,0,111715,0
2.67452,0,5975,8585,0,204.814,207457,8191,8191,4087,110,0,0,0,14,265.086,90139,0,120300,0
3.72649,0,8327,213,0,204.692,212090,1388,6463,3172,146.746,0,0,21,12,295.493,93311,0,120513,0
6.34006,0,14195,3377,0,204.75,189377,7961,7961,3377,102,0,0,41,50,245.728,96688,0,123890,0
2.62024,0,5850,8385,0,204.626,201625,6953,8103,5850,96.1175,0,0,5,10,268.563,102538,0,132275,0
4.34927,0,9711,7323,0,204.637,203262,6984,7852,9341,109,0,0,1,1,265.188,111879,0,139598,0
1.54514,0,3450,7856,0,204.629,190274,340,340,2242,120.772,0,0,2,1,284.992,114121,0,147454,0
5.28855,0,11809,2556,0,204.928,197617,7884,8073,2531,96,0,0,15,48,288.358,116652,0,150010,0
1.7856,0,3998,8264,0,204.971,194341,5974,7894,3809,127.447,0,0,6,10,292.881,120461,0,158274,0
5.25956,0,11750,1823,0,204.56,213935,5234,8145,6285,100.463,0,0,26,36,291.447,126746,0,160097,0
2.82059,0,6322,8469,0,204.652,214291,6689,6978,3411,121.922,0,0,4,12,286.658,130157,0,168566,0
4.00492,0,8942,70,0,204.703,178575,1875,8068,1164,106.004,0,0,26,4,285.965,131321,0,168636,0
5.4683,0,12209,4176,0,205.451,212187,7802,7802,4176,111,0,0,18,50,273.299,135497,0,172812,0
4.05301,0,9063,7802,0,206.106,197303,5342,8052,7802,76.5754,0,0,22,0,257.009,143299,0,180614,0
2.58927,0,5781,9383,0,206.106,197303,8052,8052,3071,111,0,0,0,17,257.009,146370,0,189997,0
4.50124,0,10055,202,0,204.82,194562,4074,8182,5368,97,0,0,13,7,252.323,151738,0,190199,0
3.79383,0,8475,8298,0,204.542,194533,6990,7778,2637,131.592,0,0,13,21,251.745,154375,0,198497,0
7.37276,0,16474,4715,0,204.647,176081,8190,8190,5525,50,0,0,28,42,266.866,159900,0,203212,0
3.23394,0,7228,8906,0,204.985,190766,7142,8044,7227,48.1928,0,0,6,8,261.365,167127,0,212118,0
2.55129,0,5698,9016,0,204.985,190766,8191,8191,4649,62,0,0,0,61,261.365,171776,0,221134,0
3.60968,0,8065,8654,0,204.793,179875,8191,8191,7031,77,0,0,5,11,244.692,178807,0,229788,0
4.55324,0,10165,648,0,205.132,199444,8144,8144,8317,93,0,0,7,13,249.034,187124,0,230436,0
3.7723,0,8423,8587,0,204.956,190596,3323,8130,5039,111,0,0,9,16,241.729,192163,0,239023,0
4.20111,0,9384,153,0,204.973,194876,2955,7982,153,44.8825,0,0,57,12,303.195,192316,0,239176,0
4.24097,0,9477,2749,0,204.64,202747,8186,8186,2749,141,0,0,12,62,295.473,195065,0,241925,0
3.32267,0,7423,8186,0,204.675,189400,1477,3988,5946,97.635,0,0,23,0,268.169,201011,0,250111,0
3.65841,0,8169,7841,0,204.651,181014,7464,8190,1579,138,0,0,7,12,258.694,202590,0,257952,0
3.59548,0,8033,223,0,205.164,203252,3811,8157,670,126,0,0,36,16,270.908,203260,0,258175,0
4.73047,0,10567,1125,0,205.633,200896,7459,8185,1125,126,0,0,32,37,287.525,204385,0,259300,0
1.93466,0,4322,8226,0,205.399,187929,5845,7519,3596,133.471,0,0,5,4,294.892,207981,0,267526,0
5.9565,0,13301,2331,0,205.779,185478,6281,8191,3752,60,0,0,31,25,269.382,211733,0,269857,0
3.54006,0,7917,10443,0,205.449,195186,7520,7693,6007,76.1208,0,0,3,38,215.88,217740,0,280300,0
3.09305,0,6908,8554,0,205.228,201672,8191,8191,5871,94,0,0,3,8,236.844,223611,0,288854,0
4.98578,0,11147,325,0,204.711,211164,7267,8080,7798,152,0,0,10,16,280.628,231409,0,289179,0
2.22399,0,4965,8461,0,204.796,198999,895,4310,3257,145.371,0,0,3,14,291.947,234666,0,297640,0
4.15325,0,9276,451,0,204.676,176666,3204,7957,451,107.939,0,0,53,20,240.369,235117,0,298091,0
3.91371,0,8748,7880,0,205.179,191084,7493,7998,794,139,0,0,21,15,275.82,235911,0,305971,0
5.77033,0,12883,2686,0,205.391,200379,6313,8191,4142,53,0,0,27,39,254.105,240053,0,308657,0
3.23247,0,7220,9860,0,205.005,208248,7042,7723,5342,82.6838,0,0,5,31,244.872,245395,0,318517,0
4.50074,0,10056,7802,0,205.078,210554,6588,6978,9296,114.982,0,0,3,5,246.731,254691,0,326319,0
2.10688,0,4708,6978,0,205.078,210554,6978,6978,4318,114.982,0,0,0,0,246.731,259009,0,333297,0
3.8262,0,8543,153,0,205.229,213460,7107,8175,946,135,0,0,7,6,277.488,259955,0,333450,0
3.80953,0,8505,7668,0,205.306,200615,3362,8127,1575,40.8037,0,0,27,0,268.057,261530,0,341118,0
5.5702,0,12446,13075,0,205.214,189755,8191,8191,7040,60,0,0,5,46,269.253,268570,0,354193,0
3.42713,0,7672,640,0,205.36,191415,8191,8191,6675,75,0,0,4,8,256.647,275245,0,354833,0
4.92283,0,10990,8709,0,205.174,203610,8113,8113,8673,99,0,0,10,32,266.138,283918,0,363542,0
3.06622,0,6851,8598,0,205.224,186194,6935,8191,6851,94.7775,0,0,4,4,254.051,290769,0,372140,0
2.14626,0,4792,8358,0,205.224,186194,8191,8191,3536,121,0,0,0,11,254.051,294305,0,380498,0
3.35175,0,7513,326,0,204.947,207699,4656,8154,529,85,0,0,22,12,263.433,294834,0,380824,0
3.18371,0,7112,8467,0,205.059,184716,5899,7062,3417,149.026,0,0,8,28,281.114,298251,0,389291,0
4.04951,0,9056,238,0,205.046,192469,3697,8102,1752,108,0,0,39,9,269.705,300003,0,389529,0
2.84803,0,6361,8478,0,205.081,197796,85,521,1867,192.289,0,0,2,18,273.244,301870,0,398007,0
4.12664,0,9228,3,0,204.937,204135,4446,8119,3,39,0,0,52,1,285.789,301873,0,398010,0
3.99245,0,8958,12403,0,205.089,196996,8176,8176,5022,107,0,0,4,95,280.188,306895,0,410413,0
4.69839,0,10497,313,0,204.505,190706,8168,8168,7658,106,0,0,22,10,256.582,314553,0,410726,0
2.33994,0,5240,8669,0,204.314,194433,1300,8083,3832,109,0,0,8,8,251.505,318385,0,419395,0
5.10357,0,11423,1552,0,204.861,198696,7467,8191,1552,102,0,0,23,50,275.005,319937,0,420947,0
1.59259,0,3557,8502,0,205.309,199942,6720,8191,2833,160.061,0,0,7,11,264.042,322770,0,429449,0
3.63198,0,8125,0,0,204.863,197268,2126,8191,4076,69.6979,0,0,30,0,312.753,326846,0,429449,0
4.97229,0,11112,4008,0,205.022,209738,8191,8191,4008,90,0,0,9,77,289.983,330854,0,433457,0
4.6503,0,10393,16227,0,204.79,196285,8036,8036,9494,86.4966,0,0,4,0,257.033,340348,0,449684,0
4.43737,0,9912,108,0,205.308,211583,3757,8191,6841,108,0,0,12,16,284.697,347189,0,449792,0
3.74439,0,8365,7993,0,205.391,201434,1391,1391,3008,115.651,0,0,4,8,281.714,350197,0,457785,0
5.11301,0,11417,2240,0,205.13,182278,8191,8191,2238,122,0,0,20,60,270.223,352435,0,460025,0
2.51431,0,5616,8383,0,204.868,175085,4616,8191,5616,98.5539,0,0,15,4,274.976,358051,0,468408,0
4.09937,0,9153,678,0,205.511,196773,4740,8191,3248,156,0,0,17,18,286.181,361299,0,469086,0
3.2991,0,7372,6587,0,205.127,198707,1901,8030,1371,101.417,0,0,24,0,266.156,362670,0,475673,0
3.87637,0,8658,478,0,204.853,202638,8187,8187,478,140,0,0,16,30,254.829,363148,0,476151,0
2.40728,0,5376,8187,0,204.131,198883,2351,7933,1434,58.1637,0,0,14,0,267.537,364582,0,484338,0
5.47758,0,12235,5029,0,204.42,204043,8191,8191,5029,85,0,0,11,51,266.45,369611,0,489367,0
4.95393,0,11079,16382,0,204.69,182951,8191,8191,10038,116,0,0,6,6,254.21,379649,0,505749,0
3.36815,0,7554,0,0,204.793,190484,8191,8191,6344,114.016,0,0,2,0,260.993,385993,0,505749,0
2.11249,0,4719,8191,0,205.368,208050,2114,8048,1871,98.8072,0,0,9,0,261.618,387864,0,513940,0
3.41643,0,7634,6434,0,205.414,212137,1454,2288,2126,151.478,0,0,6,10,260.505,389990,0,520374,0
6.94976,0,15518,5591,0,205.312,212895,8191,8191,5591,71,0,0,32,47,279.394,395581,0,525965,0
4.50415,0,10060,16382,0,205.02,193725,8191,8191,8912,86,0,0,8,13,239.25,404493,0,542347,0
4.19767,0,9378,369,0,204.782,205244,8191,8191,7839,119,0,0,6,14,252.209,412332,0,542716,0
2.87979,0,6438,8191,0,204.965,159036,2630,7829,6438,107.488,0,0,7,0,247.479,418770,0,550907,0
4.04403,0,9030,400,0,205.188,200366,6778,8085,1736,135,0,0,13,19,258.97,420506,0,551307,0
3.76713,0,8437,7787,0,205.24,154524,3508,8191,1566,40.0682,0,0,23,0,256.198,422072,0,559094,0
5.76987,0,12883,13307,0,205.627,145125,8191,8191,7434,58,0,0,6,50,245.569,429506,0,572401,0
4.11406,0,9185,8950,0,205.309,150839,8191,8191,7955,63,0,0,7,2,260.167,437461,0,581351,0
5.74841,0,12834,1976,0,205.01,186256,8191,8191,8844,108,0,0,12,25,270.623,446305,0,583327,0
3.53722,0,7901,8191,0,204.896,149134,5193,8144,6684,98.4323,0,0,8,0,274.813,452989,0,591518,0
2.14997,0,4803,8549,0,204.896,149134,8144,8144,1852,125,0,0,0,12,274.813,454841,0,600067,0
3.63542,0,8129,692,0,205.706,182818,3923,7554,1037,114,0,0,27,21,282.564,455878,0,600759,0
4.00874,0,8954,575,0,204.786,201052,2070,8077,575,97.0873,0,0,57,31,297.316,456453,0,601334,0
3.72835,0,8331,8617,0,205.028,209177,7693,8191,1317,180,0,0,12,34,286.508,457770,0,609951,0
2.80033,0,6255,0,0,205.677,209110,1563,8127,3443,121.13,0,0,19,0,295.789,461213,0,609951,0
6.10777,0,13638,4144,0,204.49,204440,8191,8191,4144,99,0,0,27,65,290.271,465357,0,614095,0
3.29986,0,7370,8191,0,204.484,184985,7080,8191,7370,92.1572,0,0,6,0,273.127,472727,0,622286,0
2.14949,0,4800,8362,0,204.559,172794,7141,7222,3689,113.032,0,0,3,6,267.839,476416,0,630648,0
4.17365,0,9320,250,0,204.742,175906,3487,8191,4314,123.663,0,0,13,8,278.363,480730,0,630898,0
5.95991,0,13306,2936,0,205.561,200274,8191,8191,2844,122,0,0,28,61,273.892,483574,0,633834,0
2.41847,0,5414,8463,0,205.36,180871,5232,7982,5414,88.1311,0,0,23,7,279.173,488988,0,642297,0
4.07185,0,9098,9750,0,205.219,181824,8070,8070,5535,79,0,0,6,28,285.879,494523,0,652047,0
4.97921,0,11125,827,0,204.405,201394,4468,8191,5268,112,0,0,15,17,278.815,499791,0,652874,0
3.12613,0,6993,8255,0,205.339,197706,914,8010,2131,117.144,0,0,6,6,261.515,501922,0,661129,0
5.66422,0,12650,2451,0,205.813,204000,8191,8191,2451,110,0,0,23,40,273.406,504373,0,663580,0
1.9325,0,4316,8381,0,206.044,180903,5778,8191,4316,106.219,0,0,10,7,280.737,508689,0,671961,0
5.31815,0,11895,2697,0,205.601,189600,8191,8191,6762,86,0,0,12,37,287.401,515451,0,674658,0
4.3692,0,9770,8191,0,205.098,196569,5873,8085,8191,81.7799,0,0,6,0,291.44,523642,0,682849,0
2.32203,0,5185,8935,0,205.074,198875,6034,6141,2973,134,0,0,2,21,300.912,526615,0,691784,0
4.97409,0,11114,2,0,204.914,193615,4642,8191,3587,37,0,0,30,1,295.176,530202,0,691786,0
4.74035,0,10590,12895,0,204.914,193615,8191,8191,7041,69,0,0,0,62,295.176,537243,0,704681,0
3.46314,0,7738,8775,0,204.728,205177,8191,8191,6439,87,0,0,5,6,265.721,543682,0,713456,0
4.86049,0,10937,7372,0,204.606,185451,7372,7372,9448,106,0,0,6,5,258.338,553130,0,720828,0
3.12778,0,6989,55,0,204.585,192269,5937,5937,6169,133,0,0,2,3,266.307,559299,0,720883,0
3.98868,0,8906,5937,0,204.737,192909,4144,8063,1608,34.3421,0,0,30,0,286.422,560907,0,726820,0
4.0141,0,8973,4001,0,204.699,184758,8191,8191,4001,111,0,0,8,67,281.295,564908,0,730821,0
5.60609,0,12523,8728,0,204.662,146299,8191,8191,8595,89,0,0,26,12,275.72,573503,0,739549,0
3.6882,0,8235,9770,0,204.575,164107,2124,4229,8235,84.4881,0,0,5,17,277.633,581738,0,749319,0
3.72064,0,8319,989,0,204.377,184827,8172,8172,1129,147,0,0,5,33,275.078,582867,0,750308,0
3.23125,0,7225,8172,0,205.238,204637,1773,8151,4719,120.442,0,0,13,0,289.535,587586,0,758480,0
6.24913,0,13956,4412,0,205.481,213270,8191,8191,4412,90,0,0,29,65,249.154,591998,0,762892,0
3.92478,0,8769,8191,0,205.221,207681,6593,8191,8191,79.295,0,0,12,0,261.219,600189,0,771083,0
2.56684,0,5731,8753,0,204.662,193406,7196,8191,4133,94.7514,0,0,6,19,285.11,604322,0,779836,0
2.57196,0,5760,145,0,204.662,193406,8191,8191,4765,137,0,0,0,7,285.11,609087,0,779981,0
3.61603,0,8087,8191,0,204.572,212998,2169,8086,3233,82.6494,0,0,27,0,286.117,612320,0,788172,0
4.40485,0,9847,2508,0,204.939,193466,8191,8191,2508,115,0,0,8,60,261.145,614828,0,790680,0
3.48914,0,7796,8191,0,204.742,208174,2861,8191,7796,88.923,0,0,20,0,272.393,622624,0,798871,0
3.38223,0,7554,8738,0,204.8,195629,5034,8191,2224,165,0,0,1,23,270.257,624848,0,807609,0
3.80557,0,8498,98,0,204.848,183314,3221,8072,1360,81,0,0,42,6,277.984,626208,0,807707,0
2.99149,0,6687,9484,0,204.871,173848,8191,8191,1635,189,0,0,1,39,279.56,627843,0,817191,0
2.79948,0,6252,0,0,204.836,183224,661,4511,5591,144.071,0,0,12,0,284.524,633434,0,817191,0
6.65333,0,14866,3642,0,205.369,202833,8022,8178,3642,74,0,0,37,41,291.989,637076,0,820833,0
2.69109,0,6010,9096,0,205.303,182944,7147,8191,5854,88.6812,0,0,7,27,274.364,642930,0,829929,0
4.12426,0,9217,8096,0,205.69,204561,4504,7568,8268,138.45,0,0,8,9,266.156,651198,0,838025,0
4.00894,0,8961,195,0,204.832,191750,3751,8191,2629,112,0,0,31,9,277.377,653827,0,838220,0
3.13533,0,7006,8271,0,204.74,197079,1058,3411,1704,156.25,0,0,2,12,280.371,655531,0,846491,0
7.2864,0,16302,5145,0,204.637,207733,8191,8191,5145,53,0,0,43,41,270.282,660676,0,851636,0
4.18418,0,9349,8638,0,204.943,176301,7889,8191,8638,57.4161,0,0,7,3,229.352,669314,0,860274,0
3.24462,0,7249,8830,0,204.649,195865,4754,7005,6947,67.9644,0,0,10,7,264.872,676261,0,869104,0
3.72658,0,8325,9435,0,204.788,202201,7954,7954,4670,85,0,0,3,79,263.393,680931,0,878539,0
4.90823,0,11012,8182,0,204.619,201826,1564,1574,9189,103.372,0,0,7,11,245.404,690120,0,886721,0
3.31311,0,7402,281,0,204.595,190628,7087,8176,1416,183,0,0,3,14,264.631,691536,0,887002,0
2.71272,0,6056,7252,0,204.25,191883,1490,8063,3068,129.626,0,0,18,0,272.861,694604,0,894254,0
6.26081,0,13988,4224,0,205.37,198870,8191,8191,4224,71,0,0,29,50,261.85,698828,0,898478,0
3.90309,0,8717,8367,0,205.366,165212,7436,8191,8367,77.2198,0,0,5,1,270.186,707195,0,906845,0
2.38907,0,5336,8477,0,205.475,189745,4280,6395,4581,92.5574,0,0,6,5,258.545,711776,0,915322,0
4.43594,0,9908,607,0,205.661,177339,2749,8191,4080,122.449,0,0,27,21,256.42,715856,0,915929,0
6.57558,0,14687,5499,0,204.933,182816,8191,8191,5499,44,0,0,22,41,272.585,721355,0,921428,0
4.99545,0,11157,17360,0,204.829,188091,8191,8191,10055,49,0,0,5,1,271.161,731410,0,938788,0
4.03089,0,9003,645,0,204.969,193781,8191,8191,7950,61,0,0,6,8,221.436,739360,0,939433,0
6.2094,0,13862,9839,0,204.786,203819,8191,8191,9431,107,0,0,9,20,263.229,748791,0,949272,0
3.24208,0,7241,8785,0,204.602,198572,1566,3849,5675,97.6009,0,0,7,3,252.121,754466,0,958057,0
3.90869,0,8726,8401,0,204.686,188202,7937,8123,1508,130,0,0,8,14,246.963,755974,0,966458,0
6.08319,0,13590,2529,0,204.945,192098,7610,8191,3131,40,0,0,27,25,291.394,759105,0,968987,0
3.51191,0,7841,11142,0,205.067,200325,7247,7970,6763,72.5513,0,0,9,26,263.967,765868,0,980129,0
3.0437,0,6795,8577,0,205.056,202159,8191,8191,5796,92,0,0,1,20,265.638,771664,0,988706,0
4.9779,0,11114,7324,0,204.827,208226,4878,5745,10857,100,0,0,5,2,254.529,782521,0,996030,0
4.3113,0,9633,442,0,204.386,179260,1831,8191,2707,98.7579,0,0,21,14,263.591,785228,0,996472,0
5.37203,0,12003,3657,0,204.481,181380,8191,8191,3657,126,0,0,19,43,256.464,788885,0,1000129,0
5.38427,0,12022,8687,0,204.937,196934,8191,8191,8537,43,0,0,25,3,266.76,797422,0,1008816,0
4.86139,0,10856,10046,0,204.792,204252,7580,7580,10196,48.29,0,0,4,24,255.538,807618,0,1018862,0
4.26905,0,9531,7996,0,204.434,198424,4564,7970,7315,59.2451,0,0,7,5,250.51,814933,0,1026858,0
3.11347,0,6951,10308,0,204.434,198424,7970,7970,3545,97,0,0,0,28,250.51,818478,0,1037166,0
4.59194,0,10255,342,0,204.285,193410,7780,7780,7105,115,0,0,6,11,259.456,825583,0,1037508,0
2.0377,0,4549,7954,0,204.311,198330,2241,4917,4549,125.12,0,0,3,7,263.607,830132,0,1045462,0
7.27226,0,16235,4609,0,205.035,202625,8122,8122,5438,61,0,0,27,51,286.982,835570,0,1050071,0
2.87414,0,6422,8350,0,205.645,202349,7022,8060,6422,81.5419,0,0,8,6,293.061,841992,0,1058421,0
2.55959,0,5715,8487,0,205.632,205457,7551,7552,4546,102.402,0,0,2,8,296.585,846538,0,1066908,0
4.4636,0,9967,7164,0,205.764,210549,6267,8183,9680,109.182,0,0,5,1,297.067,856218,0,1074072,0
3.79641,0,8477,6852,0,205.826,212774,2375,8090,5346,133,0,0,4,5,283.346,861564,0,1080924,0
6.96459,0,15549,4456,0,205.586,201640,8112,8112,4303,54,0,0,34,41,296.404,865867,0,1085380,0
4.30901,0,9627,8543,0,205.316,200291,8044,8044,8696,59.3703,0,0,5,4,281.63,874563,0,1093923,0
3.22976,0,7214,8583,0,205.92,191248,6867,8191,7214,72.6853,0,0,6,5,266.192,881777,0,1102506,0
2.86886,0,6406,8674,0,205.864,185572,6500,8191,5082,90.4755,0,0,3,22,270.432,886859,0,1111180,0
4.38449,0,9789,721,0,205.591,184353,8191,8191,5682,138,0,0,5,28,281.115,892541,0,1111901,0
1.96103,0,4383,8215,0,205.286,197006,1158,4572,3225,136.794,0,0,7,1,303.155,895766,0,1120116,0
7.29735,0,16301,5371,0,205.054,187897,8100,8191,5371,68,0,0,39,51,280.203,901137,0,1125487,0
3.79749,0,8479,8100,0,205.107,180344,7416,8191,8100,64.7003,0,0,6,0,277.574,909237,0,1133587,0
2.85068,0,6366,8522,0,204.701,190811,5297,7151,5591,77.2307,0,0,8,19,292.778,914828,0,1142109,0
3.39558,0,7587,9166,0,204.546,200558,8052,8052,4127,95,0,0,4,41,305.709,918955,0,1151275,0
4.85816,0,10853,7842,0,204.639,207468,7842,8189,9658,103,0,0,5,4,297.591,928613,0,1159117,0
4.03673,0,9014,363,0,204.783,211146,5834,8191,1840,116,0,0,20,18,260.442,930453,0,1159480,0
3.27197,0,7320,8191,0,204.8,203102,1743,8058,2893,117.184,0,0,7,1,271.771,933346,0,1167671,0
6.18129,0,13813,5109,0,205.774,192708,7981,7981,5109,54,0,0,20,49,255.366,938455,0,1172780,0
4.2558,0,9562,8331,0,205.699,194987,8191,8191,8331,77,0,0,6,10,242.674,946786,0,1181111,0
4.90168,0,10951,8499,0,205.239,191379,8191,8191,8499,93,0,0,9,12,261.303,955285,0,1189610,0
2.96201,0,6617,8668,0,204.861,177379,1382,2296,5235,85.8169,0,0,8,10,255.77,960520,0,1198278,0
3.78083,0,8442,640,0,204.91,178141,8160,8160,640,130,0,0,10,27,286.101,961160,0,1198918,0
2.84292,0,6349,8160,0,205.029,201719,2238,7967,1818,62.7261,0,0,21,0,285.64,962978,0,1207078,0
4.20722,0,9403,2884,0,205.512,200510,8191,8191,2884,124,0,0,6,55,273.501,965862,0,1209962,0
3.77087,0,8427,8191,0,204.618,193813,3481,8189,8191,85.7299,0,0,26,0,278.465,974053,0,1218153,0
2.56845,0,5743,8938,0,204.618,193813,8189,8189,1035,140,0,0,0,20,278.465,975088,0,1227091,0
4.5102,0,10080,14,0,204.471,203922,4148,8106,2901,44,0,0,28,1,319.969,977989,0,1227105,0
3.51636,0,7853,11241,0,204.547,193062,7981,7981,3261,137,0,0,2,47,314.868,981250,0,1238346,0
3.9796,0,8909,35,0,205.166,214181,2603,8159,6274,110,0,0,23,2,293.183,987524,0,1238381,0
5.71582,0,12761,2497,0,205.147,204057,7120,8088,2499,79,0,0,31,62,278.397,990023,0,1240878,0
2.46987,0,5516,8838,0,205.235,208738,7062,7801,4548,96.6089,0,0,5,19,216.799,994571,0,1249716,0
2.29172,0,5120,7891,0,205.235,208738,7801,7801,4381,123,0,0,0,5,216.799,998952,0,1257607,0
3.82188,0,8547,20,0,205.182,213886,2142,8106,5418,119,0,0,12,1,295.911,1004370,0,1257627,0
5.51212,0,12314,226,0,205.291,197198,6145,8047,226,41,0,0,47,9,274.446,1004596,0,1257853,0
4.13028,0,9223,13298,0,205.227,199402,8191,8191,7058,60,0,0,1,44,271.893,1011654,0,1271151,0
3.9913,0,8932,8928,0,205.054,189945,8191,8191,7936,74,0,0,7,28,247.136,1019590,0,1280079,0
4.51809,0,10295,832,0,204.952,152539,7829,7829,8064,87,0,0,10,13,274.03,1027654,0,1280911,0
4.46809,0,9977,7829,0,205.598,178909,8189,8189,7829,82.6838,0,0,5,0,270.288,1035483,0,1288740,0
2.44391,0,5457,8778,0,205.885,177504,1632,8191,3835,102.733,0,0,3,13,250.418,1039318,0,1297518,0
5.24948,0,11729,728,0,204.986,207154,5768,8141,728,51,0,0,38,20,276.124,1040046,0,1298246,0
3.41454,0,7626,11671,0,204.986,207154,8191,8191,5203,96,0,0,0,54,276.124,1045249,0,1309917,0
4.78928,0,10704,7960,0,204.8,212458,7353,8191,8837,111.116,0,0,11,16,269.147,1054086,0,1317877,0
4.28863,0,9583,289,0,205.285,195196,4817,8191,5880,138,0,0,11,9,277.116,1059966,0,1318166,0
3.5087,0,7840,7677,0,205.623,212531,1841,8000,1934,110.541,0,0,15,2,278.114,1061900,0,1325843,0
4.44347,0,9927,1428,0,205.897,189756,8162,8162,1428,141,0,0,21,35,273.491,1063328,0,1327271,0
3.38442,0,7556,8162,0,205.495,203290,1814,8058,4905,112.458,0,0,14,0,306.532,1068233,0,1335433,0
4.22842,0,9455,523,0,205.122,211034,8191,8191,523,122,0,0,23,27,265.698,1068756,0,1335956,0
5.15316,0,11531,8266,0,205.314,189801,4978,8143,3668,38,0,0,30,3,273.884,1072424,0,1344222,0
4.84848,0,10829,12995,0,205.314,189801,8143,8143,7664,71,0,0,0,53,273.884,1080088,0,1357217,0
3.13133,0,6995,7764,0,205.185,196852,7593,7593,6169,86,0,0,6,4,261.243,1086257,0,1364981,0
4.92482,0,10999,7059,0,204.856,204132,5424,8191,10400,119.807,0,0,5,18,287.078,1096657,0,1372040,0
3.92079,0,8760,6378,0,205.159,196900,1935,8127,5503,108.146,0,0,6,0,286.792,1102160,0,1378418,0
6.84063,0,15272,3347,0,204.953,214588,7504,8107,3214,65,0,0,29,44,279.713,1105374,0,1381765,0
2.68757,0,6001,9392,0,204.845,214689,7094,7988,5314,79.9694,0,0,6,17,273.402,1110688,0,1391157,0
4.63896,0,10358,7988,0,205.008,214923,6830,7877,9464,97.5237,0,0,4,7,269.186,1120152,0,1399145,0
4.65603,0,10401,6909,0,205.185,215123,6214,8191,9644,94.7514,0,0,2,0,277.782,1129796,0,1406054,0
1.83954,0,4109,8596,0,205.202,201700,2257,2257,2132,175,0,0,1,15,276.803,1131928,0,1414650,0
3.89443,0,8705,81,0,205.16,180009,3650,8115,823,101,0,0,43,6,258.77,1132751,0,1414731,0
2.57689,0,5755,1214,0,205.16,180009,8191,8191,1214,146,0,0,0,26,258.77,1133965,0,1415945,0
3.64411,0,8137,8191,0,204.813,204533,2801,8006,3926,46.7302,0,0,18,0,264.549,1137891,0,1424136,0
6.35094,0,14192,13600,0,204.6,198431,8191,8191,7631,57,0,0,10,43,266.715,1145522,0,1437736,0
3.6576,0,8167,719,0,205.014,178277,8191,8191,6688,79,0,0,6,3,272.765,1152210,0,1438455,0
4.81957,0,10795,16382,0,204.864,185546,8191,8191,9366,96,0,0,5,7,292.798,1161576,0,1454837,0
3.15467,0,7046,28,0,204.743,195118,5927,5927,7044,93.3124,0,0,3,4,296.279,1168620,0,1454865,0
3.86255,0,8625,6437,0,204.654,201517,5610,8068,4278,114,0,0,4,18,290.223,1172898,0,1461302,0
3.13077,0,6994,8087,0,204.647,205852,1567,2541,2969,139.873,0,0,3,2,290.307,1175867,0,1469389,0
6.79814,0,15188,5213,0,204.988,182750,8111,8111,5213,49,0,0,34,40,286.131,1181080,0,1474602,0
4.30546,0,9613,8767,0,204.941,200484,7964,7964,8767,88,0,0,6,11,280.604,1189847,0,1483369,0
4.16254,0,9298,8018,0,204.621,196540,8191,8191,8018,80.5566,0,0,8,2,238.819,1197865,0,1491387,0
2.81806,0,6295,8458,0,204.863,180044,4483,8101,6295,90.4261,0,0,10,14,264.074,1204160,0,1499845,0
2.92297,0,6529,8647,0,204.863,180044,8101,8101,2911,115,0,0,0,23,264.074,1207071,0,1508492,0
4.09174,0,9150,140,0,204.692,170055,2980,7175,3857,126,0,0,13,7,289.283,1210928,0,1508632,0
6.40086,0,14290,2988,0,205.11,166424,7957,8191,2988,71,0,0,31,47,245.407,1213916,0,1511620,0
2.05836,0,4601,9093,0,205.341,192225,6363,8036,4367,108.786,0,0,11,21,249.756,1218283,0,1520713,0
4.87356,0,10886,803,0,205.472,195835,7673,8160,5529,119,0,0,24,29,278.051,1223812,0,1521516,0
2.19832,0,4911,8215,0,205.108,190178,4301,6890,4424,124.028,0,0,5,2,282.512,1228236,0,1529731,0
5.94178,0,13266,2966,0,205.064,198213,6901,8191,3657,111,0,0,26,37,274.323,1231893,0,1532697,0
2.31185,0,5171,8488,0,205.517,190200,5807,7383,3881,112.359,0,0,7,6,256.201,1235774,0,1541185,0
3.9688,0,8869,473,0,204.681,209563,1437,7288,4047,133.547,0,0,30,19,260.919,1239821,0,1541658,0
3.84879,0,8595,401,0,204.977,210120,5891,8191,401,147,0,0,34,15,278.953,1240222,0,1542059,0
3.31243,0,7395,7104,0,206.348,176485,2101,8127,1506,96.1284,0,0,27,0,252.484,1241728,0,1549163,0
4.21815,0,9418,506,0,206.159,180507,6735,8189,506,122,0,0,25,20,268.949,1242234,0,1549669,0
3.37826,0,7551,8129,0,205.583,198468,2414,8127,1923,53.4852,0,0,17,0,297.484,1244157,0,1557798,0
5.15876,0,11526,4238,0,205.499,199908,8191,8191,4238,110,0,0,10,67,272.182,1248395,0,1562036,0
4.34576,0,9710,8191,0,205.356,203555,6202,8191,8191,81.6932,0,0,24,0,287.28,1256586,0,1570227,0
2.39676,0,5357,9037,0,205.156,204897,5902,6003,3368,114.982,0,0,3,22,269.575,1259954,0,1579264,0
3.98234,0,8896,233,0,204.959,191146,3315,8118,3681,161.015,0,0,14,10,259.083,1263635,0,1579497,0
3.90018,0,8710,433,0,205.236,203001,3055,7769,433,121.326,0,0,52,17,289.654,1264068,0,1579930,0
4.06958,0,9085,538,0,204.672,206536,7430,8164,538,159,0,0,29,18,292.773,1264606,0,1580468,0
2.73091,0,6099,8164,0,204.853,199151,1670,8019,2525,121.369,0,0,16,0,278.161,1267131,0,1588632,0
6.57097,0,14683,5301,0,204.723,208044,8191,8191,5301,50,0,0,27,44,266.534,1272432,0,1593933,0
4.14071,0,9248,8198,0,204.527,211540,8191,8191,8198,55.1149,0,0,6,1,272.183,1280630,0,1602131,0
3.99728,0,8924,9071,0,204.211,201334,7201,8191,8924,75.4716,0,0,7,4,266.9,1289554,0,1611202,0
2.4489,0,5477,8371,0,204.331,199877,5750,7567,4487,89.5522,0,0,6,10,261.468,1294041,0,1619573,0
3.40559,0,7607,637,0,204.384,205915,8191,8191,4668,108,0,0,4,26,264.756,1298709,0,1620210,0
3.8062,0,8502,8380,0,204.715,204784,3394,8191,4148,130,0,0,8,9,282.655,1302857,0,1628590,0
6.23415,0,13926,3395,0,205.053,207124,8191,8191,3316,77,0,0,30,47,295.074,1306173,0,1631985,0
3.08382,0,6887,8645,0,205.542,212430,7151,8058,6887,88.8566,0,0,8,7,229.958,1313060,0,1640630,0
4.17613,0,9324,7836,0,205.621,213540,6780,8191,8639,123.267,0,0,3,4,248.611,1321699,0,1648466,0
1.89676,0,4236,8191,0,205.622,195166,2,2,2823,118.871,0,0,2,0,261.649,1324522,0,1656657,0
3.50427,0,7828,416,0,205.236,174927,4173,8145,416,122,0,0,29,20,248.515,1324938,0,1657073,0
2.82326,0,6304,8049,0,205.193,188200,732,8099,1559,132.514,0,0,3,1,251.763,1326497,0,1665122,0
6.78877,0,15159,4539,0,204.804,185890,8104,8104,4403,65,0,0,32,52,278.52,1330900,0,1669661,0
2.62684,0,5869,8284,0,204.438,169805,4518,7959,5869,88.7746,0,0,25,7,252.121,1336769,0,1677945,0
3.43229,0,7677,871,0,204.388,170277,8053,8053,3422,131,0,0,8,23,264.118,1340191,0,1678816,0
3.47196,0,7762,8053,0,204.839,197884,12,5825,7750,102.737,0,0,16,0,277.369,1347941,0,1686869,0
3.43821,0,7685,7279,0,204.989,189911,6991,8155,639,165,0,0,3,13,281.213,1348580,0,1694148,0
3.83571,0,8569,137,0,205.391,188893,3278,8191,1080,129,0,0,43,5,293.312,1349660,0,1694285,0
3.16411,0,7064,8572,0,205.395,179430,129,129,2151,129,0,0,1,14,292.843,1351811,0,1702857,0
3.93747,0,8797,447,0,205.261,208715,3729,7968,447,109.295,0,0,37,16,297.401,1352258,0,1703304,0
4.65807,0,10402,488,0,206.014,180523,4042,8035,488,111,0,0,40,29,257.978,1352746,0,1703792,0
3.31108,0,7402,8640,0,205.599,164273,523,523,2689,120.482,0,0,5,11,275.917,1355435,0,1712432,0
5.22271,0,11668,2540,0,205.008,199112,8141,8141,2540,108,0,0,15,58,287.384,1357975,0,1714972,0
2.63802,0,5891,8421,0,204.928,205604,4684,7833,5891,91.665,0,0,12,8,278.989,1363866,0,1723393,0
4.3805,0,9791,2089,0,204.721,204064,8126,8126,4619,99,0,0,9,80,268.826,1368485,0,1725482,0
3.92209,0,8762,8126,0,204.473,210825,4558,8107,7761,90.9007,0,0,8,0,269.534,1376246,0,1733608,0


