SendRate(Mb/s),ReceiveRate(Mb/s),SendPackets,Send Loss,Recv Loss,RTT(ms),CWnd,OutstandingData,FlowWindow,Retrans,PktSndPeriod(us),SendACK,SendNAK,RecvACK,RecvNAK,EstimatedBandwidth(Mb/s),Retrans_Total, NAK_TotalSent,Total Send Loss,Total Recv Loss
0.011586,0,26,1,0,108.159,48913,4,8190,1,52023.4,0,0,5,1,0.21728,1,0,1,0
0.0152286,0,34,0,0,183.583,5564,9,8190,0,19715.3,0,0,21,0,0.43456,1,0,1,0
0.0398655,0,89,0,0,205.089,40,25,8189,0,8148.49,0,0,49,0,0.45248,1,0,1,0
0.0801748,0,179,0,0,206.587,50,45,8189,0,4449.94,0,0,71,0,0.473536,1,0,1,0
0.0895719,0,200,0,0,207.858,43,40,8187,0,3147.4,0,0,64,0,0.458752,1,0,1,0
0.100287,0,224,0,0,206.025,55,51,8185,0,2546.33,0,0,51,0,0.561792,1,0,1,0
5.20806,0,11631,3582,0,206.106,136418,7179,8191,3582,87,0,0,40,56,189.175,3583,0,3583,0
2.24419,0,5011,8951,0,206.381,197209,6555,7847,3999,105.263,0,0,12,20,238.008,7582,0,12534,0
3.92527,0,8769,590,0,205.942,186242,8191,8191,5542,142,0,0,13,31,266.041,13124,0,13124,0
3.2578,0,7284,8191,0,205.089,188609,2406,7916,4579,64.7571,0,0,12,0,241.407,17703,0,21315,0
3.86925,0,8645,8530,0,204.985,153542,0,471,2556,124,0,0,8,18,245.62,20259,0,29845,0
6.80881,0,15213,4362,0,204.868,194424,8191,8191,4400,66,0,0,25,51,275.958,24659,0,34207,0
2.95845,0,6606,8622,0,204.824,177429,7119,7862,6606,81.8683,0,0,4,5,268.847,31265,0,42829,0
4.29354,0,9588,7862,0,205.156,195954,6666,7820,8845,111.07,0,0,5,4,269.105,40110,0,50691,0
1.84368,0,4117,7831,0,205.203,188733,0,622,2963,120.482,0,0,3,2,275.04,43073,0,58522,0
7.19851,0,16086,5181,0,205.052,160141,8191,8191,5263,87,0,0,25,52,220.171,48336,0,63703,0
3.13673,0,7004,8255,0,204.633,170571,7139,8069,7004,92.5573,0,0,6,5,200.642,55340,0,71958,0
4.40974,0,9850,7568,0,204.714,168628,5870,8179,8825,104.13,0,0,9,5,243.085,64165,0,79526,0
3.7233,0,8313,6770,0,204.816,194378,1890,8191,4977,105.61,0,0,16,6,216.278,69142,0,86296,0
6.04945,0,13523,4793,0,204.598,204716,8191,8191,4793,95,0,0,19,65,258.677,73935,0,91089,0
4.23082,0,9449,16287,0,204.997,180688,8096,8126,8282,86.3831,0,0,9,0,218.117,82217,0,107376,0
3.62425,0,8101,0,0,204.892,188640,7929,7929,8005,109.182,0,0,2,8,224.944,90222,0,107376,0
2.70098,0,6032,8053,0,204.861,173965,3276,8089,2206,129,0,0,7,8,218.313,92428,0,115429,0
4.68324,0,10459,1278,0,205.095,142852,5277,8052,1278,107,0,0,33,31,256.448,93706,0,116707,0
2.66613,0,5955,8147,0,205.106,159796,6401,6541,3180,134.241,0,0,2,9,264.414,96886,0,124854,0
7.1151,0,15898,4406,0,205.479,173462,8189,8191,4439,84,0,0,31,49,248.278,101325,0,129260,0
2.09547,0,4679,8644,0,205.015,155461,5804,8015,4677,97.9003,0,0,15,8,234.458,106002,0,137904,0
4.26422,0,9527,1389,0,204.999,171591,8099,8099,5356,122,0,0,14,33,277.752,111358,0,139293,0
3.71783,0,8305,8099,0,205.785,170976,1976,4328,6329,104.748,0,0,11,0,233.603,117687,0,147392,0
3.81614,0,8521,8279,0,205.636,169376,8115,8183,1858,123.266,0,0,7,8,210.25,119545,0,155671,0
4.62145,0,10320,1563,0,204.987,193636,5959,8149,1611,66,0,0,26,30,273.693,121156,0,157234,0
2.62216,0,5856,9514,0,204.997,198653,7713,7756,3666,106.278,0,0,2,35,267.154,124822,0,166748,0
4.46238,0,9966,7777,0,205.113,193304,4767,5335,7830,161.015,0,0,14,16,305.562,132652,0,174525,0
3.40003,0,7595,0,0,204.937,197931,2098,8191,3870,96.0557,0,0,35,0,256.439,136522,0,174525,0
3.91877,0,8753,8610,0,205.027,198463,8191,8191,788,135,0,0,15,23,286.01,137310,0,183135,0
3.26147,0,7282,0,0,204.71,204557,3335,7998,1165,38.4506,0,0,28,0,258.669,138475,0,183135,0
4.79636,0,10725,12808,0,204.969,208164,8191,8191,5476,88,0,0,3,54,269.519,143951,0,195943,0
4.971,0,11109,8147,0,204.688,203608,6840,7197,10155,101.793,0,0,10,7,268.714,154106,0,204090,0
4.30015,0,9604,7199,0,204.642,207226,1676,1795,8307,126,0,0,3,3,281.284,162413,0,211289,0
5.34414,0,11933,2009,0,204.578,195842,8108,8191,2009,122,0,0,26,41,305.387,164422,0,213298,0
1.77699,0,3968,8280,0,205.256,183368,5918,8191,3885,118.394,0,0,9,6,244.114,168307,0,221578,0
5.37149,0,12035,2525,0,205.938,183341,5115,5115,6920,89,0,0,12,35,276.825,175227,0,224103,0
3.71576,0,8301,5182,0,205.541,189835,7206,8191,5182,96,0,0,5,1,240.046,180409,0,229285,0
2.3321,0,5214,8915,0,205.308,179853,5814,7067,4229,111.773,0,0,6,11,222.708,184638,0,238200,0
4.14131,0,9246,166,0,204.701,197096,1903,7993,2992,107.383,0,0,19,8,276.632,187630,0,238366,0
5.62402,0,12562,4159,0,204.495,193008,8191,8191,4159,115,0,0,19,57,254.624,191789,0,242525,0
3.68127,0,8219,8191,0,205.531,182092,3041,7624,8191,53.3456,0,0,26,0,190.557,199980,0,250716,0
4.38557,0,9795,3489,0,205.638,196033,8175,8175,3489,110,0,0,4,51,208.086,203469,0,254205,0
4.63166,0,10349,8175,0,205.741,172010,4588,8118,8078,61.9542,0,0,21,0,222.495,211547,0,262380,0
2.76703,0,6181,10131,0,205.741,172010,8118,8118,2651,114,0,0,0,62,222.495,214198,0,272511,0
4.39864,0,9824,0,0,204.864,144558,2354,6057,7470,91.9798,0,0,16,0,210.461,221668,0,272511,0
3.91226,0,8743,8682,0,204.784,176366,7774,7792,2644,112.099,0,0,6,16,223.38,224312,0,281193,0
3.52925,0,7886,372,0,204.983,199301,5920,8191,564,131,0,0,15,21,278.087,224876,0,281565,0
6.20282,0,13850,8367,0,205.127,171050,6946,8191,3433,45,0,0,28,28,226.858,228309,0,289932,0
3.5138,0,7849,11466,0,205.272,172270,7680,8191,6275,82.8862,0,0,6,29,183.497,234584,0,301398,0
4.95819,0,11075,8191,0,205.175,195369,7073,7816,9947,98.4374,0,0,8,9,214.867,244531,0,309589,0
2.17886,0,4868,7893,0,205.175,195369,7816,7816,4125,141,0,0,0,4,214.867,248656,0,317482,0
3.60625,0,8060,0,0,204.608,177063,1997,8004,4188,85.1628,0,0,25,0,218.3,252844,0,317482,0
4.97618,0,11123,3495,0,204.731,174048,8071,8071,3495,156,0,0,13,61,214.713,256339,0,320977,0
2.85393,0,6374,8071,0,204.864,177039,3292,7697,6374,92.9346,0,0,32,0,263.706,262713,0,329048,0
3.56791,0,7969,8318,0,204.749,160376,7734,7734,2722,129,0,0,4,16,246.9,265435,0,337366,0
5.77892,0,12916,936,0,205.339,178790,6575,8070,3798,43,0,0,28,28,253.203,269233,0,338302,0
4.12511,0,9213,12203,0,205.175,184683,7544,7893,7597,69.5192,0,0,5,42,240.305,276830,0,350505,0
2.78904,0,6231,488,0,205.109,194693,8191,8191,5221,86,0,0,3,7,233.801,282052,0,350993,0
4.83956,0,10807,8489,0,205.483,206312,8191,8191,8489,103,0,0,6,7,244.71,290541,0,359482,0
2.78482,0,6219,8555,0,205.37,180701,5695,8167,6219,98.4374,0,0,6,9,231.588,296760,0,368037,0
4.2046,0,9390,7443,0,205.196,188913,1910,8000,5850,106.952,0,0,10,7,219.151,302610,0,375480,0
4.60935,0,10293,2405,0,204.926,168128,8081,8081,2405,165,0,0,15,65,260.957,305015,0,377885,0
2.35894,0,5271,8081,0,204.248,207001,4322,7740,5271,114.147,0,0,19,0,262.076,310286,0,385966,0
3.73462,0,8341,278,0,204.209,206299,1450,8090,3088,132.197,0,0,25,13,264.079,313374,0,386244,0
5.77058,0,12892,2599,0,205.575,183902,8191,8191,2599,129,0,0,35,57,244.365,315973,0,388843,0
1.7964,0,4011,8465,0,205.274,152975,6225,7959,4011,80.6495,0,0,11,11,226.403,319984,0,397308,0
6.31094,0,14090,10773,0,204.866,171000,8178,8178,10072,44,0,0,12,14,205.05,330056,0,408081,0
6.27403,0,14008,7756,0,205.244,176988,3607,8191,12911,42.868,0,0,7,0,214.39,342967,0,415837,0
5.5281,0,12350,11554,0,205.149,195550,7227,7408,7766,61.8313,0,0,4,38,221.284,350733,0,427391,0
3.12756,0,6983,8555,0,205.132,197986,8140,8140,6045,99,0,0,1,5,225.772,356778,0,435946,0
2.88407,0,6440,0,0,204.998,181478,6557,6557,6298,96.1443,0,0,3,0,212.625,363076,0,435946,0
2.5806,0,5764,6557,0,204.932,192488,2947,6748,5764,92.1572,0,0,3,0,241.95,368840,0,442503,0
4.25241,0,9494,604,0,205.179,173693,7487,8191,1097,142,0,0,8,18,263.485,369937,0,443107,0
6.22267,0,13895,10346,0,204.975,172514,7232,8191,3468,43,0,0,27,22,209.844,373405,0,453453,0
4.04339,0,9030,10965,0,204.875,188947,7115,7845,8071,60.7052,0,0,6,36,206.882,381476,0,464418,0
3.26121,0,7281,8147,0,204.863,165533,7443,8191,6551,78,0,0,2,10,198.644,388027,0,472565,0
4.72688,0,10553,1411,0,204.745,184134,8191,8191,6437,98,0,0,14,19,256.262,394464,0,473976,0
3.69138,0,8245,8191,0,204.894,168323,4334,8072,7775,88.8566,0,0,8,0,236.535,402239,0,482167,0
2.55128,0,5696,8622,0,204.832,174096,0,121,1958,162,0,0,1,20,246.578,404197,0,490789,0
6.3831,0,14262,3876,0,205.127,143206,6704,8191,3668,63,0,0,39,37,245.514,407865,0,494665,0
2.71342,0,6061,9058,0,205.73,164357,6704,7630,4573,87.6336,0,0,5,20,216.69,412438,0,503723,0
4.68073,0,10453,8121,0,206.545,166534,7077,7488,8597,118.843,0,0,6,15,222.993,421035,0,511844,0
2.27138,0,5074,7488,0,206.545,166534,7488,7488,4663,118.843,0,0,0,0,222.993,425698,0,519332,0
3.47439,0,7761,273,0,206.477,147696,4181,8190,1770,135,0,0,20,9,229.574,427468,0,519605,0
2.96976,0,6631,7647,0,205.987,185196,1127,8128,1530,120.374,0,0,6,0,244.186,428998,0,527252,0
4.18613,0,9350,653,0,207.025,186526,6502,8191,653,152,0,0,24,27,206.451,429651,0,527905,0
3.20245,0,7153,7733,0,205.555,183085,1725,8066,3029,115.221,0,0,16,0,266.568,432680,0,535638,0
5.74164,0,12841,3905,0,206.793,179792,8166,8166,3905,97,0,0,21,62,258.052,436585,0,539543,0
3.40771,0,7609,8166,0,206.218,177801,7011,8191,7609,94.257,0,0,4,0,221.154,444194,0,547709,0
4.50196,0,10052,7472,0,205.807,176331,2373,8191,7283,126,0,0,7,3,240.889,451477,0,555181,0
4.60266,0,10277,268,0,204.381,170706,5060,8191,268,51,0,0,47,16,171.931,451745,0,555449,0
3.93374,0,8799,12458,0,204.593,184315,8191,8191,5100,85,0,0,5,55,171.245,456845,0,567907,0
4.57576,0,10224,612,0,204.678,175582,8191,8191,7970,98,0,0,10,15,185.751,464815,0,568519,0
2.56524,0,5728,8191,0,205.107,160755,4883,8191,5728,87.6879,0,0,10,0,225.036,470543,0,576710,0
2.86511,0,6397,626,0,205.107,160755,8191,8191,3089,142,0,0,0,22,225.036,473632,0,577336,0
3.96159,0,8855,8191,0,204.829,190580,3341,8003,3099,41.68,0,0,26,0,296.305,476731,0,585527,0
5.88622,0,13147,13594,0,204.729,195245,8117,8117,7317,71,0,0,11,44,246.629,484048,0,599121,0
3.47899,0,7768,485,0,204.613,200030,8142,8142,6762,86,0,0,8,6,208.098,490810,0,599606,0
5.20221,0,11629,8507,0,204.218,200663,8191,8191,8497,101,0,0,8,9,220.299,499307,0,608113,0
2.7398,0,6130,8674,0,204.242,168463,2394,4272,6130,95.2291,0,0,5,11,217.104,505437,0,616787,0
3.97945,0,8890,368,0,204.959,180343,2106,8070,983,94.9454,0,0,39,19,197.671,506420,0,617155,0
4.74317,0,10590,2649,0,204.67,170009,7938,7938,2649,137,0,0,15,61,209.242,509069,0,619804,0
2.56916,0,5738,7938,0,204.712,197927,3510,8191,5738,91.7492,0,0,18,0,203.792,514807,0,627742,0
6.22586,0,13915,3546,0,204.782,164917,8084,8084,5680,107,0,0,8,65,222.304,520487,0,631288,0
2.92247,0,6540,8341,0,204.791,163750,5035,8191,6540,84.0631,0,0,19,4,231.093,527027,0,639629,0
2.89723,0,6469,8869,0,204.791,163750,8191,8191,3313,107,0,0,0,24,231.093,530340,0,648498,0
3.63607,0,8119,110,0,204.818,208295,2005,8018,2441,99.5594,0,0,29,6,223.596,532781,0,648608,0
4.56217,0,10192,2662,0,204.773,196094,8150,8150,2662,108,0,0,13,79,251.502,535443,0,651270,0
4.19462,0,9372,8150,0,205.637,184307,1247,5975,8150,51.7885,0,0,26,0,226.38,543593,0,659420,0
4.27526,0,9545,2600,0,205.464,166250,8104,8104,2600,140,0,0,2,42,249.832,546193,0,662020,0
3.19245,0,7129,8104,0,204.876,181001,1391,4202,5738,109.976,0,0,14,0,251.079,551931,0,670124,0
5.41283,0,12091,822,0,205.981,181965,5761,8132,822,61,0,0,37,26,213.335,552753,0,670946,0
2.48237,0,5546,10833,0,205.763,164465,8191,8191,3046,99,0,0,2,57,216.087,555799,0,681779,0
4.74723,0,10615,7773,0,205.387,192413,7773,8191,9932,117,0,0,6,3,225.581,565731,0,689552,0
3.90489,0,8723,6279,0,205.111,187981,934,1912,7532,113.032,0,0,3,0,245.754,573263,0,695831,0
6.08783,0,13599,444,0,204.919,176124,6612,8020,444,36,0,0,35,15,287.936,573707,0,696275,0
4.07904,0,9108,12912,0,204.919,176124,8191,8191,7529,53,0,0,0,39,287.936,581236,0,709187,0
3.95223,0,8834,8460,0,204.622,186895,8191,8191,7780,76,0,0,5,6,287.119,589016,0,717647,0
4.13175,0,9226,904,0,205.393,192379,8017,8017,6967,90,0,0,8,15,278.99,595983,0,718551,0
4.47378,0,10005,16016,0,205.117,170245,7999,7999,8296,86.4966,0,0,5,0,254.778,604279,0,734567,0
4.23415,0,9458,372,0,204.913,191944,3316,8191,4077,116.788,0,0,27,28,227.791,608356,0,734939,0
4.46699,0,9974,925,0,205.394,199315,8023,8188,925,132,0,0,25,41,213.811,609281,0,735864,0
3.46761,0,7745,8188,0,205.677,180511,2038,7999,3988,100.243,0,0,18,0,271.633,613269,0,744052,0
3.87917,0,8682,9143,0,205.261,177406,8191,8191,1372,134,0,0,10,38,228.236,614641,0,753195,0
3.83729,0,8572,0,0,205.078,166264,2166,8106,4320,92.9135,0,0,27,0,201.92,618961,0,753195,0
3.98406,0,8948,2158,0,204.926,173616,8190,8190,2158,129,0,0,8,64,228.226,621119,0,755353,0
3.53339,0,7893,8190,0,204.94,193872,1310,4442,6583,98.5031,0,0,17,0,236.568,627702,0,763543,0
4.01972,0,8976,8515,0,205.578,178028,8090,8090,1397,115.413,0,0,7,14,215.683,629099,0,772058,0
2.60909,0,5826,106,0,206.049,154939,2844,7506,997,183,0,0,13,7,217.839,630096,0,772164,0
5.75276,0,12847,2482,0,205.266,151103,6811,8191,2364,69,0,0,47,41,228.041,632460,0,774646,0
3.09061,0,6904,9726,0,205.573,157059,6553,7402,5524,85.7363,0,0,3,28,222.996,637984,0,784372,0
4.60885,0,10304,8106,0,205.634,158192,5692,8191,8143,103.405,0,0,13,19,271.939,646127,0,792478,0
4.34415,0,9708,451,0,205.21,163856,6898,8191,4394,131,0,0,10,15,280.279,650521,0,792929,0
3.86573,0,8631,7918,0,204.79,143636,2155,8068,3435,94.0414,0,0,24,0,233.169,653956,0,800847,0
3.71067,0,8286,9037,0,204.571,157797,8096,8096,1535,135,0,0,9,32,253.859,655491,0,809884,0
3.68497,0,8227,54,0,205.093,171883,3428,8144,4467,125,0,0,14,2,249.597,659958,0,809938,0
6.64652,0,14839,4134,0,204.83,177790,8191,8191,4134,63,0,0,26,52,249.117,664092,0,814072,0
3.71749,0,8301,8608,0,205.015,158186,7206,8191,8301,74.6266,0,0,8,9,250.039,672393,0,822680,0
2.29771,0,5131,8359,0,204.946,168149,6586,8142,4146,99.051,0,0,6,7,261.26,676539,0,831039,0
4.29818,0,9602,7268,0,205.21,173528,3438,5546,8920,121.736,0,0,3,3,270.206,685459,0,838307,0
5.62554,0,12562,2147,0,205.308,151475,7369,8181,3040,89,0,0,23,42,253.173,688499,0,840454,0
2.14415,0,4788,8859,0,205.266,129631,6713,7790,3976,110.23,0,0,3,26,241.499,692475,0,849313,0
5.68662,0,12705,1789,0,204.88,198087,5792,8191,6701,121,0,0,22,32,256.222,699176,0,851102,0
3.07547,0,6867,8725,0,204.654,207374,6029,7770,4468,108.116,0,0,14,11,275.125,703644,0,859827,0
4.08518,0,9130,397,0,205.003,191071,6608,8191,2408,134,0,0,12,10,268.708,706052,0,860224,0
4.34139,0,9708,7860,0,205.258,190684,3534,8113,1736,65,0,0,31,2,260.946,707788,0,868084,0
3.15437,0,7046,2153,0,205.22,193724,8191,8191,2153,137,0,0,1,54,257.143,709941,0,870237,0
3.91925,0,8751,8191,0,205.702,164866,1061,5493,7690,95.7002,0,0,24,0,245.598,717631,0,878428,0
4.17607,0,9323,627,0,205.454,187355,7499,8191,627,128,0,0,12,24,272.61,718258,0,879055,0
4.92317,0,11021,7828,0,204.894,174324,4815,8186,2836,56,0,0,30,6,239.484,721094,0,886883,0
3.67642,0,8212,12047,0,204.894,174324,8186,8186,4841,90,0,0,0,55,239.484,725935,0,898930,0
4.73298,0,10589,7991,0,205.064,138983,5911,6112,9673,137.12,0,0,8,4,224.626,735608,0,906921,0
3.77397,0,8436,0,0,204.792,182914,2181,8127,4921,94.4031,0,0,25,0,233.149,740529,0,906921,0
3.3398,0,7457,8429,0,204.678,183309,8017,8017,626,141,0,0,9,26,212.172,741155,0,915350,0
4.44915,0,9934,0,0,205.287,146160,5236,8191,1350,28.9498,0,0,32,0,238.168,742505,0,915350,0
5.80271,0,12963,13386,0,205.359,150184,7159,7713,9974,54.1795,0,0,6,41,226.777,752479,0,928736,0
3.71124,0,8288,8139,0,205.251,152226,6665,7693,7480,67.6005,0,0,5,4,232.262,759959,0,936875,0
3.16587,0,7069,8011,0,205.251,152226,7693,7693,6041,77,0,0,0,5,232.262,766000,0,944886,0
3.66609,0,8191,448,0,205.195,166957,8191,8191,6489,97,0,0,2,15,231.055,772489,0,945334,0
3.97512,0,8878,8440,0,205.761,173388,2699,7679,4456,109.341,0,0,12,7,270.278,776945,0,953774,0
6.49803,0,14543,3570,0,205.295,181837,6505,8191,3570,68,0,0,28,37,266.775,780515,0,957344,0
2.76201,0,6167,9039,0,205.416,169677,7160,7982,4481,90.0569,0,0,7,19,284.247,784996,0,966383,0
4.75628,0,10625,7737,0,205.192,188414,6236,8177,10048,97.5236,0,0,4,3,281.073,795044,0,974120,0
4.03738,0,9017,7436,0,204.776,192479,1741,8030,5351,108.192,0,0,15,8,305.562,800395,0,981556,0
5.4347,0,12137,3436,0,205.254,193167,8191,8191,3436,96,0,0,22,67,240.325,803831,0,984992,0
3.66669,0,8187,8191,0,204.96,171458,6093,8152,8187,83.9158,0,0,11,0,234.405,812018,0,993183,0
2.34425,0,5236,8641,0,204.844,163374,6416,6456,3177,118.843,0,0,2,19,233.015,815195,0,1001824,0
3.84228,0,8583,97,0,204.499,134234,4958,8191,2767,146,0,0,13,5,238.655,817962,0,1001921,0
2.99058,0,6682,7362,0,204.471,168763,1772,8066,1510,115.616,0,0,12,0,240.623,819472,0,1009283,0
5.87253,0,13155,3276,0,205.128,184133,8132,8132,3276,99,0,0,28,86,263.531,822748,0,1012559,0
2.31095,0,5160,8359,0,205.143,194944,4491,7529,5160,104.313,0,0,13,8,207.454,827908,0,1020918,0
4.71261,0,10529,2452,0,204.806,186333,8191,8191,5651,149,0,0,9,32,207.386,833559,0,1023370,0
2.52819,0,5645,8191,0,204.907,181953,2016,7610,5645,121.782,0,0,13,0,235.515,839204,0,1031561,0
3.9127,0,8748,101,0,204.44,190088,1732,8093,684,120.595,0,0,25,9,235.328,839888,0,1031662,0
5.23037,0,11678,2320,0,204.347,194951,6843,8094,2320,178,0,0,36,58,231.386,842208,0,1033982,0
2.36368,0,5280,8155,0,204.209,157631,5532,7752,4029,137.59,0,0,12,2,209.476,846237,0,1042137,0
5.32893,0,11904,1304,0,204.57,186890,6230,8191,2615,61,0,0,30,28,286.23,848852,0,1043441,0
2.85165,0,6369,10066,0,204.465,179882,7480,7778,4408,96.1443,0,0,3,39,257.79,853260,0,1053507,0
4.58389,0,10247,7592,0,204.71,185760,3996,8191,9823,111.148,0,0,7,3,266.031,863083,0,1061099,0
3.84852,0,8617,168,0,205.419,151202,5952,8191,2216,145,0,0,10,12,246.169,865299,0,1061267,0
3.90501,0,8724,7340,0,206.801,186552,3587,7898,1484,38.7647,0,0,20,0,258.749,866783,0,1068607,0
4.21476,0,9412,12249,0,206.99,196712,8131,8131,4630,88,0,0,3,59,260.129,871413,0,1080856,0
4.93665,0,11023,7924,0,206.4,188314,6819,8191,10075,106.278,0,0,7,11,218.536,881488,0,1088780,0
4.10461,0,9172,8057,0,206.296,178216,573,707,7934,135,0,0,1,3,221.373,889422,0,1096837,0
5.16842,0,11542,2125,0,206.474,185747,7304,8191,2155,84,0,0,24,43,202.259,891577,0,1098962,0
2.43011,0,5432,9033,0,206.067,195526,6393,6395,4545,105.31,0,0,3,24,207.56,896122,0,1107995,0
5.77338,0,12894,2091,0,205.555,163351,6181,8072,6612,98,0,0,23,44,228.251,902734,0,1110086,0
2.20284,0,4919,8499,0,205.47,166986,6890,7486,3028,118.343,0,0,4,15,215.045,905762,0,1118585,0
4.97016,0,11102,1291,0,204.698,167904,3914,8070,6762,112.083,0,0,19,30,228.519,912524,0,1119876,0
2.89861,0,6474,8058,0,204.604,176929,7916,7916,1475,138,0,0,5,10,213.494,913999,0,1127934,0
5.2295,0,11680,1618,0,206.031,153998,6749,8075,1626,48,0,0,32,21,237.102,915625,0,1129552,0
2.88987,0,6455,10811,0,205.704,143070,7482,7484,5013,110.149,0,0,3,35,204.776,920638,0,1140363,0
4.58251,0,10236,933,0,204.884,197186,8111,8111,7005,111,0,0,17,28,217.701,927643,0,1141296,0
3.08449,0,6887,8111,0,204.95,160714,3105,6056,6887,85.4042,0,0,10,0,249.298,934530,0,1149407,0
4.69003,0,10477,1474,0,204.85,183079,8191,8191,2037,129,0,0,4,40,231.589,936567,0,1150881,0
3.76624,0,8417,8286,0,205.153,150451,2778,8128,5517,85,0,0,13,3,270.058,942084,0,1159167,0
4.18633,0,9355,9095,0,205.492,145709,8150,8191,2457,131,0,0,10,37,225.112,944541,0,1168262,0
6.61865,0,14780,3018,0,204.556,195488,6957,8109,5395,45,0,0,27,37,235.256,949936,0,1171280,0
2.68962,0,6010,10314,0,204.585,199987,8191,8191,4678,75,0,0,2,27,240.762,954614,0,1181594,0
4.67282,0,10434,7927,0,205.22,179761,6137,8000,9625,96.1173,0,0,12,11,228.355,964239,0,1189521,0
4.17208,0,9316,688,0,205.298,178080,8112,8112,4774,122,0,0,9,19,255.798,969013,0,1190209,0
3.4809,0,7775,8136,0,204.769,165920,2470,8191,4635,113,0,0,14,1,240.968,973648,0,1198345,0
5.28675,0,11805,2067,0,206.216,170799,5821,8191,2067,85,0,0,29,30,218.441,975715,0,1200412,0
2.19526,0,4901,8597,0,206.104,165595,7208,7209,2531,135.201,0,0,2,10,207.756,978246,0,1209009,0
5.8138,0,12979,2096,0,205.235,172438,4597,8173,8162,86,0,0,16,30,215.918,986408,0,1211105,0
2.51252,0,5614,8821,0,205.22,177777,8156,8156,2020,124,0,0,1,23,223.061,988428,0,1219926,0
6.83218,0,15254,3191,0,205.031,159518,8138,8138,9992,60,0,0,19,43,236.467,998420,0,1223117,0
5.2969,0,11833,8160,0,204.562,186158,7891,8125,7943,67,0,0,5,1,236.604,1006363,0,1231277,0
3.07711,0,6875,9959,0,204.622,195593,7122,8191,6641,83.8369,0,0,3,21,230.519,1013004,0,1241236,0
4.76874,0,10653,8191,0,204.645,161256,976,4726,9584,94.8243,0,0,10,10,258.223,1022588,0,1249427,0
3.93083,0,8779,7320,0,204.717,160396,6951,8092,2498,132,0,0,3,20,245.591,1025086,0,1256747,0
4.8752,0,10891,970,0,205.228,201348,5545,8182,1961,86,0,0,34,29,273.771,1027047,0,1257717,0
2.19189,0,4896,9015,0,205.228,201348,8191,8191,2250,140,0,0,0,25,273.771,1029297,0,1266732,0
3.93465,0,8797,0,0,205.234,173547,2195,8136,6547,100.071,0,0,22,0,239.829,1035844,0,1266732,0
7.27668,0,16249,4311,0,205.015,196458,7763,8191,4193,51,0,0,35,60,285.416,1040037,0,1271043,0
4.84358,0,10822,9325,0,205.047,206726,7973,7973,9443,49.1209,0,0,6,10,281.892,1049480,0,1280368,0
2.81273,0,6280,8522,0,204.754,176767,6066,8191,6062,81.2273,0,0,11,27,261.406,1055542,0,1288890,0
4.37828,0,9789,8191,0,205.479,177372,1848,4670,7664,105.853,0,0,7,13,240.985,1063206,0,1297081,0
4.11378,0,9188,8360,0,205.277,176125,8041,8146,2306,125,0,0,6,14,232.149,1065512,0,1305441,0
5.01616,0,11207,352,0,205.396,179766,5165,8081,3178,58,0,0,29,12,269.326,1068690,0,1305793,0
3.3912,0,7572,11555,0,205.396,179766,8191,8191,4546,96,0,0,0,57,269.326,1073236,0,1317348,0
4.66673,0,10444,7795,0,205.744,161538,6621,7017,9804,117,0,0,5,3,250.28,1083040,0,1325143,0
4.17275,0,9318,158,0,205.085,162624,1919,8061,2516,107.18,0,0,26,11,243.506,1085556,0,1325301,0
5.9272,0,13236,3981,0,205.254,145592,8191,8191,3981,88,0,0,25,88,223.264,1089537,0,1329282,0
3.86451,0,8633,8191,0,205.064,174643,7626,8115,8191,83.5864,0,0,6,0,214.52,1097728,0,1337473,0
4.52683,0,10109,8115,0,204.487,178378,5720,7519,8115,93.4946,0,0,10,8,241.892,1105843,0,1345588,0
2.29618,0,5127,7936,0,204.677,168226,3283,3964,3328,129.745,0,0,3,18,233.05,1109171,0,1353524,0
5.38415,0,12022,1775,0,204.97,176690,6160,8191,2189,85,0,0,35,36,206.239,1111360,0,1355299,0
2.39243,0,5351,9361,0,205.078,167835,7619,7621,3320,117.692,0,0,3,31,189.513,1114680,0,1364660,0
4.5152,0,10089,514,0,204.975,174302,3504,8166,6560,158,0,0,24,15,232.577,1121240,0,1365174,0
4.05901,0,9066,490,0,205.232,189222,1941,8045,490,104.313,0,0,51,16,234.72,1121730,0,1365664,0
4.12305,0,9224,8572,0,206.453,170288,8091,8091,674,125,0,0,20,17,298.874,1122404,0,1374236,0
7.39453,0,16513,4154,0,205.327,165064,7685,8191,5638,45,0,0,30,39,250.273,1128042,0,1378390,0
3.43936,0,7687,9547,0,205.215,173368,7201,8183,7181,62.8871,0,0,6,16,256.978,1135223,0,1387937,0
3.10207,0,6928,8417,0,205.08,159706,6826,6836,5946,78.125,0,0,3,4,241.015,1141169,0,1396354,0
5.02416,0,11218,7203,0,205.053,177966,6186,7175,10841,85.8791,0,0,3,1,230.764,1152010,0,1403557,0
4.38145,0,9786,7175,0,205.173,168313,2137,8055,6524,95.7771,0,0,11,6,233.809,1158534,0,1410732,0
4.45526,0,9951,387,0,205.363,142500,4621,8191,350,69,0,0,52,27,205.151,1158884,0,1411119,0
2.89625,0,6469,10803,0,205.363,142500,8191,8191,2899,160,0,0,0,58,205.151,1161783,0,1421922,0
3.34083,0,7460,0,0,205.125,168087,2113,7050,7460,111.732,0,0,20,0,227.848,1169243,0,1421922,0
4.33945,0,9689,124,0,204.974,180432,2781,8191,429,45.5524,0,0,40,8,206.196,1169672,0,1422046,0
4.24466,0,9498,12014,0,204.984,184776,8191,8191,3824,88,0,0,2,65,214.7,1173496,0,1434060,0
4.96137,0,11093,8191,0,204.923,183604,8191,8191,9153,103,0,0,8,6,236.868,1182649,0,1442251,0
4.59488,0,10261,84,0,204.721,180147,7929,8037,7312,122,0,0,7,11,222.764,1189961,0,1442335,0
1.77069,0,3958,8420,0,204.856,179935,237,5399,3613,132.514,0,0,3,15,226.585,1193574,0,1450755,0
7.16841,0,16017,5273,0,205.228,186190,8191,8191,5273,108,0,0,26,60,232.75,1198847,0,1456028,0
3.03596,0,6784,8255,0,205.697,189320,4772,8191,6784,85.7686,0,0,18,1,241.203,1205631,0,1464283,0
2.88209,0,6440,8884,0,205.697,189320,8191,8191,3021,110,0,0,0,24,241.203,1208652,0,1473167,0
4.52466,0,10105,535,0,205.036,171493,3288,8161,6787,162,0,0,17,12,236.854,1215439,0,1473702,0
3.70645,0,8279,434,0,204.925,191854,3579,8109,485,162,0,0,51,24,241.252,1215924,0,1474136,0
2.92928,0,6541,6565,0,205.148,182404,1420,8050,1328,135.633,0,0,9,0,216.355,1217252,0,1480701,0
4.06623,0,9087,672,0,205.079,161461,6204,8191,672,149,0,0,34,22,211.098,1217924,0,1481373,0
4.53997,0,10142,7368,0,205.536,176894,4346,8083,1528,33.7137,0,0,33,0,255.492,1219452,0,1488741,0
3.88209,0,8672,4206,0,205.611,195771,8191,8191,4206,112,0,0,6,56,266.931,1223658,0,1492947,0
3.64978,0,8149,8191,0,205.284,171728,5639,8191,8149,91.9237,0,0,17,0,234.082,1231807,0,1501138,0
4.27518,0,9552,7894,0,205.415,182761,1775,7758,6331,98.0678,0,0,12,16,255.035,1238138,0,1509032,0
4.05367,0,9053,9087,0,205.295,206720,7973,7973,1441,152,0,0,11,40,281.029,1239579,0,1518119,0
3.53757,0,7902,0,0,206.403,168715,2058,8062,3986,98.2417,0,0,28,0,258.927,1243565,0,1518119,0
4.19278,0,9404,446,0,204.609,189721,3301,7966,446,89,0,0,55,24,192.095,1244011,0,1518565,0
2.67554,0,5974,1084,0,204.609,189721,8191,8191,1084,165,0,0,0,41,192.095,1245095,0,1519649,0
2.66561,0,5952,8191,0,204.673,177362,1127,3316,4825,137.73,0,0,9,0,212.051,1249920,0,1527840,0
7.09516,0,15842,5497,0,205.069,179225,8090,8090,5497,56,0,0,33,45,225.699,1255417,0,1533337,0
4.16359,0,9297,8456,0,205.134,172055,7871,7871,8456,62,0,0,5,1,219.959,1263873,0,1541793,0
4.35145,0,9734,8603,0,204.793,161011,7442,7442,8603,98,0,0,6,4,205.092,1272476,0,1550396,0
3.4316,0,7665,7442,0,204.451,178633,2309,8191,5356,91.2901,0,0,7,0,223.057,1277832,0,1557838,0
6.69178,0,14950,3420,0,204.88,193016,7390,8191,3420,87,0,0,33,57,255.478,1281252,0,1561258,0
2.36395,0,5281,9609,0,204.985,155057,6386,7472,4480,102.469,0,0,6,18,246.748,1285732,0,1570867,0
4.01804,0,8991,597,0,205.04,163599,8179,8179,5726,112,0,0,12,22,196.6,1291458,0,1571464,0
3.21542,0,7183,8179,0,204.831,154067,117,4975,7066,100.215,0,0,8,0,217.312,1298524,0,1579643,0
3.62081,0,8085,7522,0,204.891,161710,7306,8191,796,144,0,0,1,12,208.182,1299320,0,1587165,0
4.83907,0,10808,911,0,205.065,171543,5211,8086,1860,70,0,0,34,20,242.769,1301180,0,1588076,0
3.05251,0,6817,9686,0,205.216,168912,7694,7694,3214,129,0,0,4,26,242.833,1304394,0,1597762,0
4.00463,0,8944,262,0,205.423,171634,3239,7612,4153,151.761,0,0,24,15,226.277,1308547,0,1598024,0
6.92714,0,15479,5307,0,205.88,192312,8153,8153,5307,50,0,0,33,52,238.936,1313854,0,1603331,0
4.36539,0,9752,8722,0,205.483,184127,8191,8191,8722,63,0,0,6,32,241.908,1322576,0,1612053,0
4.12053,0,9203,8217,0,205.272,157425,8191,8191,8217,60.7052,0,0,5,1,224.457,1330793,0,1620270,0
3.29422,0,7357,8555,0,205.459,151500,5769,7798,7357,74.5128,0,0,6,12,198.121,1338150,0,1628825,0
2.56556,0,5729,8400,0,205.408,166454,6678,8191,3700,134.241,0,0,2,11,196.135,1341850,0,1637225,0
4.19441,0,9368,380,0,204.856,149388,4832,8191,1390,111,0,0,31,18,230.368,1343240,0,1637605,0
2.65759,0,5938,8226,0,204.961,171086,4869,6050,2579,169.877,0,0,3,4,245.36,1345819,0,1645831,0
5.137,0,11471,682,0,204.808,183711,5837,8191,1690,60,0,0,43,14,246.338,1347509,0,1646513,0
3.40403,0,7606,11962,0,204.808,183711,8191,8191,5252,98,0,0,0,44,246.338,1352761,0,1658475,0
4.79849,0,10742,7283,0,204.942,195260,5208,7411,10583,91.2901,0,0,8,1,237.559,1363344,0,1665758,0
4.27336,0,9544,632,0,205.218,188221,8191,8191,4122,124,0,0,5,25,241.299,1367466,0,1666390,0
3.77833,0,8437,8517,0,204.808,154379,3598,8191,2159,130,0,0,27,16,188.132,1369625,0,1674907,0
4.44241,0,9918,913,0,204.506,164799,6343,8191,929,130,0,0,34,42,238.852,1370554,0,1675820,0
3.79324,0,8471,8150,0,205.778,204840,2077,8083,3075,99.0854,0,0,18,0,248.463,1373629,0,1683970,0
3.97541,0,8876,1018,0,206.108,184463,6838,7775,1018,166,0,0,19,34,262.483,1374647,0,1684988,0
3.27037,0,7316,6905,0,205.857,189501,2111,8079,2770,99.2643,0,0,30,0,228.155,1377417,0,1691893,0
3.85093,0,8605,730,0,206.036,211981,8184,8184,730,131,0,0,14,37,235.657,1378147,0,1692623,0
4.86774,0,10870,8257,0,206.159,190899,4992,8090,2660,44,0,0,32,3,174.453,1380807,0,1700880,0
4.40681,0,9842,12930,0,206.077,184881,8173,8173,6643,74,0,0,1,59,177.734,1387450,0,1713810,0
3.68027,0,8221,506,0,205.543,168816,8191,8191,6793,99,0,0,8,9,215.276,1394243,0,1714316,0
4.12341,0,9214,8191,0,205.342,174496,8191,8191,8191,97.5512,0,0,2,0,201.288,1402434,0,1722507,0


