SendRate(Mb/s),ReceiveRate(Mb/s),RecvPackets,Send Loss,Recv Loss,RTT(ms),CWnd,FlowWindow,Retrans,PktSndPeriod(us),SendACK,SendNAK,RecvACK,RecvNAK,EstimatedBandwidth(Mb/s),Retrans_Total, NAK_TotalSent,Total Send Loss,Total Recv Loss
0.0226505,0,0,0,0,100,2,8192,0,0,0,0,0,0,0.011648,0,0,0,0
48.3477,0,0,21,0,10.874,62,8189,21,0,0,0,1919,17,73.4173,21,0,21,0
7.13958,0,0,12,0,12.718,66,8189,12,0,0,0,271,11,56.4928,33,0,33,0
43.0433,0,0,97,0,16.377,64,8185,97,0,0,0,1586,31,29.8888,130,0,130,0
48.8403,0,0,60,0,17.198,87,8183,60,0,0,0,1722,55,34.4548,190,0,190,0
3.00079,0,0,87,0,8.02,44,8189,24,0,0,0,103,0,34.4082,214,0,277,0
21.3592,0,0,24,0,11.47,60,8191,24,0,0,0,814,21,45.1593,238,0,301,0
30.2686,0,0,70,0,10.935,56,8189,70,0,0,0,1193,10,44.5187,308,0,371,0
9.88567,0,0,16,0,12.214,62,8191,16,0,0,0,362,16,49.7719,324,0,387,0
18.1214,0,0,66,0,9.213,48,8190,51,0,0,0,731,3,40.966,375,0,453,0
17.705,0,0,48,0,8.314,44,8187,48,0,0,0,716,0,34.513,423,0,501,0
24.022,0,0,21,0,12.094,61,8190,21,0,0,0,926,20,976.207,444,0,522,0
24.9035,0,0,69,0,10.011,52,8189,64,0,0,0,970,8,103.131,508,0,591,0
54.6746,0,0,64,0,16.257,82,8190,63,0,0,0,1974,54,57.5411,571,0,655,0
9.7661,0,0,13,0,16.828,85,8181,14,0,0,0,329,12,45.4039,585,0,668,0
41.4843,0,0,120,0,8.643,68,8191,120,0,0,0,1535,29,1194.42,705,0,788,0
3.10989,0,0,7,0,13.747,70,8191,7,0,0,0,123,6,1117.64,712,0,795,0
47.7415,0,0,96,0,13.739,69,8189,82,0,0,0,1863,20,76.9933,794,0,891,0
0.162919,0,0,5,0,13.588,69,8189,5,0,0,0,2,3,76.9933,799,0,896,0
38.799,0,0,88,0,12.301,63,8187,88,0,0,0,1469,16,43.0976,887,0,984,0
14.3955,0,0,18,0,12.953,71,8187,18,0,0,0,517,16,36.004,905,0,1002,0
34.073,0,0,87,0,11.883,61,8190,48,0,0,0,1310,15,234.463,953,0,1089,0
55.1321,0,0,74,0,17.511,87,8189,73,0,0,0,1957,59,373.342,1026,0,1163,0
4.86524,0,0,10,0,17.716,89,8191,11,0,0,0,161,8,260.857,1037,0,1173,0
33.9146,0,0,117,0,9.742,65,8189,117,0,0,0,1223,26,774.755,1154,0,1290,0
3.31796,0,0,9,0,13.109,67,8178,9,0,0,0,132,6,531.452,1163,0,1299,0
35.4207,0,0,85,0,11.905,60,8187,66,0,0,0,1344,17,55.1766,1229,0,1384,0
19.1064,0,0,31,0,13.914,71,8191,31,0,0,0,691,25,38.9043,1260,0,1415,0
21.8841,0,0,81,0,10.27,53,8191,81,0,0,0,863,9,65.3569,1341,0,1496,0
5.23673,0,0,53,0,5.614,31,8189,53,0,0,0,184,0,54.2098,1394,0,1549,0
41.304,0,0,27,0,12.6,64,8191,27,0,0,0,1591,21,299.051,1421,0,1576,0
9.39768,0,0,64,0,7.611,40,8189,64,0,0,0,353,0,126.917,1485,0,1640,0
42.7618,0,0,37,0,12.028,69,8189,37,0,0,0,1569,34,43.7615,1522,0,1677,0
41.2416,0,0,69,0,17.364,87,8167,69,0,0,0,1442,60,70.2724,1591,0,1746,0
9.42074,0,0,87,0,9.536,50,8189,22,0,0,0,370,0,54.8737,1613,0,1833,0
52.6995,0,0,68,0,15.452,79,8173,68,0,0,0,1890,60,40.768,1681,0,1901,0
0,0,0,0,0,15.452,79,8173,0,0,0,0,0,0,40.768,1681,0,1901,0
49.5191,0,0,131,0,14.107,71,8189,102,0,0,0,1841,46,46.5571,1783,0,2032,0
0,0,0,0,0,14.107,71,8189,0,0,0,0,0,0,46.5571,1783,0,2032,0
54.288,0,0,149,0,9.572,71,8189,149,0,0,0,1976,60,421.693,1932,0,2181,0
12.9425,0,0,24,0,15.206,77,8183,24,0,0,0,469,22,147.569,1956,0,2205,0
38.7707,0,0,110,0,12.414,65,8189,110,0,0,0,1432,28,45.8349,2066,0,2315,0
7.56463,0,0,10,0,13.357,69,8156,10,0,0,0,265,8,40.4652,2076,0,2325,0
28.8308,0,0,83,0,11.092,57,8190,77,0,0,0,1090,11,32.8241,2153,0,2408,0
42.3787,0,0,53,0,15.238,78,8165,53,0,0,0,1467,49,58.7875,2206,0,2461,0
8.08917,0,0,78,0,8.434,44,8189,78,0,0,0,288,0,45.3224,2284,0,2539,0
25.9344,0,0,34,0,12.106,62,8190,34,0,0,0,972,28,33.7559,2318,0,2573,0
21.9851,0,0,68,0,9.772,51,8189,62,0,0,0,869,5,89.841,2380,0,2641,0
6.26279,0,0,9,0,10.836,55,8191,9,0,0,0,240,7,87.2319,2389,0,2650,0
27.5925,0,0,61,0,10.41,53,8189,61,0,0,0,1085,5,52.416,2450,0,2711,0
18.7005,0,0,25,0,12.687,65,8190,25,0,0,0,710,21,45.4505,2475,0,2736,0
32.2924,0,0,87,0,11.175,58,8189,87,0,0,0,1225,17,99.3924,2562,0,2823,0
30.8747,0,0,42,0,14.568,74,8189,42,0,0,0,1060,37,32.6144,2604,0,2865,0
0,0,0,0,0,14.568,74,8191,0,0,0,0,0,0,32.6144,2604,0,2865,0
45.0965,0,0,107,0,13.337,68,8179,107,0,0,0,1672,28,36.7611,2711,0,2972,0
0.837988,0,0,68,0,12.943,4,8125,68,0,0,0,2,0,36.7028,2779,0,3040,0
37.1057,0,0,37,0,12.213,62,8189,37,0,0,0,1434,33,31.5544,2816,0,3077,0
12.6223,0,0,62,0,7.945,43,8187,62,0,0,0,491,0,53.5109,2878,0,3139,0
41.2091,0,0,46,0,13.695,70,8185,46,0,0,0,1543,39,44.3206,2924,0,3185,0
9.42156,0,0,70,0,8.126,43,8189,70,0,0,0,351,0,39.7546,2994,0,3255,0
5.98392,0,0,5,0,9.231,48,8191,5,0,0,0,252,5,35.2701,2999,0,3260,0
41.803,0,0,65,0,12.056,62,8189,65,0,0,0,1664,15,707.744,3064,0,3325,0
52.4271,0,0,87,0,17.102,86,8170,87,0,0,0,1834,76,388.484,3151,0,3412,0
0,0,0,0,0,17.102,86,8170,0,0,0,0,0,0,388.484,3151,0,3412,0
53.6129,0,0,136,0,15.2,75,8189,136,0,0,0,1929,45,54.1166,3287,0,3548,0
10.4635,0,0,23,0,15.832,79,8189,23,0,0,0,367,19,44.0527,3310,0,3571,0
38.7789,0,0,108,0,10.3,65,8187,108,0,0,0,1424,28,33.3832,3418,0,3679,0
37.0598,0,0,65,0,16.53,82,8191,65,0,0,0,1293,53,30.18,3483,0,3744,0
13.8113,0,0,90,0,9.647,51,8191,90,0,0,0,502,5,40.6748,3573,0,3834,0
50.9759,0,0,57,0,15.572,79,8171,57,0,0,0,1852,51,63.7495,3630,0,3891,0
0.954987,0,0,79,0,15.343,3,8112,79,0,0,0,1,0,60.8724,3709,0,3970,0
11.2726,0,0,5,0,9.161,48,8191,5,0,0,0,460,5,45.0079,3714,0,3975,0
30.8838,0,0,62,0,10.006,54,8187,40,0,0,0,1238,14,34.8858,3754,0,4037,0
4.74891,0,0,54,0,6.713,31,8183,54,0,0,0,163,0,37.0872,3808,0,4091,0
20.3824,0,0,9,0,9.966,51,8191,9,0,0,0,841,8,36.3068,3817,0,4100,0
25.6166,0,0,57,0,9.843,51,8190,57,0,0,0,1042,4,35.9807,3874,0,4157,0
54.9111,0,0,57,0,16.291,81,8189,57,0,0,0,2017,49,43.2141,3931,0,4214,0
11.404,0,0,24,0,15.65,86,8179,24,0,0,0,360,21,36.2835,3955,0,4238,0
25.4462,0,0,105,0,11.57,60,8189,89,0,0,0,924,18,33.057,4044,0,4343,0
29.1853,0,0,43,0,14.938,75,8191,43,0,0,0,1050,37,38.0191,4087,0,4386,0
22.3713,0,0,87,0,10.56,54,8189,87,0,0,0,848,8,36.3301,4174,0,4473,0
10.2333,0,0,13,0,10.649,61,8190,13,0,0,0,379,12,33.4996,4187,0,4486,0
41.1001,0,0,82,0,12.421,63,8189,82,0,0,0,1595,16,48.1761,4269,0,4568,0
0.232782,0,0,5,0,12.412,63,8191,5,0,0,0,8,5,48.1761,4274,0,4573,0
37.7535,0,0,80,0,10.979,61,8189,54,0,0,0,1467,16,944.443,4328,0,4653,0
55.0074,0,0,62,0,17.546,88,8189,62,0,0,0,1959,57,425.606,4390,0,4715,0
15.7915,0,0,32,0,18.768,94,8189,32,0,0,0,540,31,195.547,4422,0,4747,0
24.0299,0,0,120,0,11.783,61,8187,120,0,0,0,837,23,55.2232,4542,0,4867,0
7.98877,0,0,61,0,6.976,37,8187,61,0,0,0,295,0,47.3608,4603,0,4928,0
37.0239,0,0,34,0,12.812,65,8190,34,0,0,0,1443,30,835.406,4637,0,4962,0
13.4044,0,0,65,0,8.335,44,8189,65,0,0,0,523,0,193.007,4702,0,5027,0
39.3403,0,0,29,0,13.903,70,8189,29,0,0,0,1503,28,1074.12,4731,0,5056,0
9.15186,0,0,70,0,8.119,43,8191,44,0,0,0,351,0,395.485,4775,0,5126,0
40.1242,0,0,40,0,13.537,69,8185,40,0,0,0,1490,35,45.7417,4815,0,5166,0
11.3781,0,0,69,0,8.318,44,8189,69,0,0,0,433,0,36.2253,4884,0,5235,0
32.5515,0,0,32,0,12.785,65,8181,32,0,0,0,1180,30,194.114,4916,0,5267,0
15.2206,0,0,65,0,8.779,46,8189,65,0,0,0,599,0,323.209,4981,0,5332,0
55.358,0,0,60,0,14.654,78,8189,60,0,0,0,2019,54,372.748,5041,0,5392,0
4.99519,0,0,9,0,15.946,80,8191,9,0,0,0,174,9,232.366,5050,0,5401,0
26.3993,0,0,102,0,11.435,59,8185,51,0,0,0,1010,21,54.303,5101,0,5503,0
3.09781,0,0,59,0,5.119,31,8189,59,0,0,0,90,0,47.3142,5160,0,5562,0
19.8864,0,0,10,0,9.718,51,8190,10,0,0,0,818,8,598.847,5170,0,5572,0
31.1071,0,0,58,0,10.402,55,8189,58,0,0,0,1234,6,98.2858,5228,0,5630,0
31.9021,0,0,38,0,14.282,73,8174,38,0,0,0,1193,35,58.3565,5266,0,5668,0
18.7678,0,0,80,0,9.746,51,8190,67,0,0,0,729,6,420.994,5333,0,5748,0
0,0,0,0,0,9.746,51,8190,0,0,0,0,0,0,420.994,5333,0,5748,0
48.7547,0,0,77,0,12.972,65,8189,77,0,0,0,1880,23,54.6058,5410,0,5825,0
8.70742,0,0,13,0,13.836,70,8173,13,0,0,0,316,10,1315.35,5423,0,5838,0
19.6576,0,0,78,0,9.916,51,8189,67,0,0,0,764,6,332.935,5490,0,5916,0
15.3819,0,0,51,0,13.258,42,8189,51,0,0,0,615,0,92.124,5541,0,5967,0
45.5651,0,0,51,0,13.921,72,8189,51,0,0,0,1688,41,39.1023,5592,0,6018,0
5.14301,0,0,72,0,8.301,39,8189,72,0,0,0,167,0,38.1472,5664,0,6090,0
25.8781,0,0,24,0,11.457,59,8189,24,0,0,0,992,23,249.78,5688,0,6114,0
22.8874,0,0,64,0,9.717,50,8190,64,0,0,0,906,4,59.9639,5752,0,6178,0
0,0,0,0,0,9.717,50,8190,0,0,0,0,0,0,59.9639,5752,0,6178,0
31.5692,0,0,66,0,9.773,55,8190,66,0,0,0,1255,13,56.7374,5818,0,6244,0
16.8396,0,0,55,0,8.455,45,8189,55,0,0,0,675,0,67.7448,5873,0,6299,0
14.9547,0,0,14,0,10.79,56,8189,14,0,0,0,583,14,344.035,5887,0,6313,0
31.4328,0,0,69,0,10.943,56,8191,69,0,0,0,1244,11,87.9424,5956,0,6382,0
0.314113,0,0,56,0,10.776,3,8135,24,0,0,0,1,0,84.9372,5980,0,6438,0
23.7091,0,0,11,0,9.937,51,8189,11,0,0,0,970,10,231.97,5991,0,6449,0
27.6343,0,0,59,0,9.865,52,8189,59,0,0,0,1088,7,53.7089,6050,0,6508,0
43.532,0,0,53,0,14.659,76,8164,53,0,0,0,1554,47,40.57,6103,0,6561,0
7.15862,0,0,76,0,7.748,43,8189,76,0,0,0,249,0,45.8465,6179,0,6637,0
30.3502,0,0,30,0,12.414,63,8189,30,0,0,0,1112,28,373.679,6209,0,6667,0
44.4234,0,0,54,0,16.442,84,8190,54,0,0,0,1557,49,36.8776,6263,0,6721,0
6.16696,0,0,84,0,8.521,45,8189,84,0,0,0,202,0,54.0118,6347,0,6805,0
29.9829,0,0,33,0,12.828,65,8183,33,0,0,0,1110,29,41.7348,6380,0,6838,0
20.2085,0,0,66,0,9.634,50,8189,66,0,0,0,789,1,38.916,6446,0,6904,0
36.4294,0,0,57,0,13.433,71,8191,57,0,0,0,1309,44,42.2124,6503,0,6961,0
2.14276,0,0,71,0,4.65,35,8187,71,0,0,0,40,0,43.0394,6574,0,7032,0
54.6252,0,0,44,0,14.264,73,8189,43,0,0,0,2062,35,38.6131,6617,0,7076,0
15.8102,0,0,21,0,15.641,80,8186,21,0,0,0,562,17,605.894,6638,0,7097,0
34.3566,0,0,109,0,12.399,63,8181,72,0,0,0,1282,26,54.1166,6710,0,7206,0
0,0,0,0,0,12.399,63,8181,0,0,0,0,0,0,54.1166,6710,0,7206,0
26.0122,0,0,75,0,10.02,54,8186,75,0,0,0,1011,8,42.4337,6785,0,7281,0
21.8787,0,0,55,0,9.157,49,8189,55,0,0,0,867,1,37.3202,6840,0,7336,0
40.5524,0,0,45,0,14.389,73,8190,45,0,0,0,1490,36,158.087,6885,0,7381,0
48.1582,0,0,79,0,18.396,93,8187,79,0,0,0,1637,68,34.2801,6964,0,7460,0
4.92568,0,0,93,0,9.097,48,8189,75,0,0,0,151,0,34.1636,7039,0,7553,0
52.4839,0,0,72,0,15.463,78,8182,72,0,0,0,1946,63,486.222,7111,0,7625,0
0,0,0,0,0,15.463,78,8182,0,0,0,0,0,0,486.222,7111,0,7625,0
51.9392,0,0,129,0,14.315,72,8189,84,0,0,0,1918,37,42.4104,7195,0,7754,0
43.9934,0,0,72,0,17.97,91,8190,72,0,0,0,1521,65,39.1256,7267,0,7826,0
0,0,0,0,0,17.97,91,8191,0,0,0,0,0,0,39.1256,7267,0,7826,0
43.5916,0,0,133,0,13.961,71,8180,111,0,0,0,1601,40,80.1499,7378,0,7959,0
2.51437,0,0,71,0,6.967,35,8189,71,0,0,0,56,0,68.8746,7449,0,8030,0
49.0066,0,0,47,0,13.651,70,8190,47,0,0,0,1842,41,423.952,7496,0,8077,0
2.85312,0,0,70,0,5.858,36,8189,70,0,0,0,70,0,293.693,7566,0,8147,0
52.1224,0,0,53,0,14.093,72,8190,53,0,0,0,1964,46,35.7943,7619,0,8200,0
0.838481,0,0,72,0,14.093,2,8190,72,0,0,0,0,0,35.7943,7691,0,8272,0
40.2464,0,0,27,0,12.482,65,8145,27,0,0,0,1505,23,47.1977,7718,0,8299,0
9.42141,0,0,12,0,13.627,69,8177,12,0,0,0,330,10,42.7016,7730,0,8311,0
29.4954,0,0,83,0,10.981,57,8169,83,0,0,0,1103,14,43.7499,7813,0,8394,0
9.09593,0,0,12,0,12.277,62,8191,12,0,0,0,328,11,49.6205,7825,0,8406,0
21.8436,0,0,69,0,9.705,51,8191,69,0,0,0,861,7,35.2003,7894,0,8475,0
5.56637,0,0,51,0,5.161,31,8189,51,0,0,0,199,0,33.4531,7945,0,8526,0
40.815,0,0,26,0,12.52,64,8190,26,0,0,0,1606,20,44.4604,7971,0,8552,0
9.73662,0,0,64,0,7.721,41,8189,53,0,0,0,372,0,38.2753,8024,0,8616,0
34.0375,0,0,35,0,12.776,65,8191,35,0,0,0,1285,30,31.3914,8059,0,8651,0
5.32213,0,0,65,0,6.66,36,8191,65,0,0,0,179,0,33.9073,8124,0,8716,0
48.5339,0,0,50,0,13.458,70,8174,50,0,0,0,1831,41,47.1628,8174,0,8766,0
3.34242,0,0,70,0,6.614,36,8189,55,0,0,0,100,0,43.6567,8229,0,8836,0
48.9087,0,0,46,0,13.967,71,8191,46,0,0,0,1859,40,37.658,8275,0,8882,0
1.87491,0,0,71,0,5.166,33,8187,71,0,0,0,31,0,36.9475,8346,0,8953,0
54.3453,0,0,57,0,14.338,72,8189,57,0,0,0,2050,51,59.5795,8403,0,9010,0
28.6943,0,0,42,0,16.498,85,8183,42,0,0,0,983,37,35.1537,8445,0,9052,0
8.86026,0,0,90,0,9.11,48,8190,63,0,0,0,328,3,33.9306,8508,0,9142,0
9.16423,0,0,48,0,6.24,35,8191,48,0,0,0,354,0,33.0337,8556,0,9190,0
27.464,0,0,24,0,9.812,58,8188,24,0,0,0,1088,19,201.103,8580,0,9214,0
18.8367,0,0,60,0,9.129,47,8191,60,0,0,0,757,2,52.9402,8640,0,9274,0
1.17566,0,0,47,0,5.433,20,8189,47,0,0,0,18,0,48.4906,8687,0,9321,0
55.3326,0,0,45,0,13.089,68,8189,45,0,0,0,2090,37,37.1688,8732,0,9366,0
40.737,0,0,64,0,17.203,86,8191,64,0,0,0,1407,57,42.7831,8796,0,9430,0
0,0,0,0,0,17.203,86,8191,0,0,0,0,0,0,42.7831,8796,0,9430,0
48.8938,0,0,134,0,14.31,72,8191,134,0,0,0,1756,41,851.76,8930,0,9564,0
0,0,0,0,0,14.31,72,8191,0,0,0,0,0,0,851.76,8930,0,9564,0
53.8307,0,0,120,0,14.169,72,8189,120,0,0,0,1986,41,46.1377,9050,0,9684,0
55.8497,0,0,88,0,17.988,94,8189,88,0,0,0,1874,77,34.2568,9138,0,9772,0
12.3312,0,0,20,0,11.841,99,8190,20,0,0,0,431,18,33.3016,9158,0,9792,0
25.6354,0,0,122,0,11.722,63,8128,122,0,0,0,856,20,532.325,9280,0,9914,0
50.5186,0,0,66,0,16.987,86,8173,66,0,0,0,1727,56,64.2737,9346,0,9980,0
1.09338,0,0,86,0,16.277,5,8189,86,0,0,0,3,0,61.2335,9432,0,10066,0
43.6782,0,0,43,0,14.004,71,8189,43,0,0,0,1654,38,67.2672,9475,0,10109,0
3.01506,0,0,71,0,6.21,36,8189,71,0,0,0,77,0,57.6809,9546,0,10180,0
12.3277,0,0,8,0,9.217,48,8191,8,0,0,0,520,8,48.8634,9554,0,10188,0
38.5845,0,0,65,0,8.517,59,8189,65,0,0,0,1525,16,850.234,9619,0,10253,0
18.6368,0,0,22,0,13.399,70,8189,22,0,0,0,667,19,2036.26,9641,0,10275,0
30.3959,0,0,98,0,10.095,58,8189,98,0,0,0,1151,19,191.959,9739,0,10373,0
10.9187,0,0,11,0,12.794,65,8191,11,0,0,0,424,8,134.581,9750,0,10384,0
21.2072,0,0,71,0,9.769,51,8190,52,0,0,0,840,5,44.8681,9802,0,10455,0
9.23497,0,0,51,0,6.573,35,8189,51,0,0,0,355,0,40.7214,9853,0,10506,0
52.5342,0,0,58,0,14.08,72,8173,58,0,0,0,1997,50,78.6589,9911,0,10564,0
0,0,0,0,0,14.08,72,8173,0,0,0,0,0,0,78.6589,9911,0,10564,0
23.8825,0,0,88,0,10.525,55,8191,80,0,0,0,922,11,35.4682,9991,0,10652,0
24.734,0,0,59,0,9.816,51,8189,59,0,0,0,988,2,508.191,10050,0,10711,0
55.3445,0,0,69,0,12.218,80,8189,69,0,0,0,1948,66,257.654,10119,0,10780,0
7.89324,0,0,13,0,16.563,84,8172,13,0,0,0,281,11,1423.92,10132,0,10793,0
21.5005,0,0,101,0,10.979,56,8189,101,0,0,0,778,14,320.565,10233,0,10894,0
4.73841,0,0,56,0,5.827,32,8189,34,0,0,0,172,0,182.967,10267,0,10950,0
25.3579,0,0,20,0,9.806,55,8191,20,0,0,0,1026,17,1221.48,10287,0,10970,0
25.6023,0,0,70,0,8.023,51,8189,65,0,0,0,995,11,157.097,10352,0,11040,0
3.00233,0,0,5,0,10.395,54,8189,5,0,0,0,125,4,131.122,10357,0,11045,0
49.1,0,0,91,0,12.909,66,8189,91,0,0,0,1890,30,530.345,10448,0,11136,0
55.5409,0,0,78,0,18.044,91,8189,78,0,0,0,1944,66,1224.95,10526,0,11214,0
17.5291,0,0,26,0,19.197,98,8190,26,0,0,0,632,21,527.666,10552,0,11240,0
22.3821,0,0,117,0,12.149,62,8190,90,0,0,0,815,17,1253.22,10642,0,11357,0
7.67258,0,0,62,0,6.957,38,8189,62,0,0,0,281,0,1067.64,10704,0,11419,0
20.2358,0,0,11,0,10.747,55,8191,11,0,0,0,814,11,157.376,10715,0,11430,0
16.9792,0,0,55,0,8.504,45,8189,55,0,0,0,680,0,1367.6,10770,0,11485,0
13.6955,0,0,17,0,10.731,55,8190,17,0,0,0,532,15,300.845,10787,0,11502,0
27.4463,0,0,65,0,10.315,53,8191,65,0,0,0,1102,8,53.3362,10852,0,11567,0
4.32027,0,0,53,0,5.402,30,8189,53,0,0,0,145,0,46.8483,10905,0,11620,0
29.0071,0,0,16,0,11.008,57,8187,16,0,0,0,1181,16,48.1878,10921,0,11636,0
19.1937,0,0,59,0,9.058,47,8191,59,0,0,0,773,2,47.1278,10980,0,11695,0
0,0,0,0,0,9.058,47,8191,0,0,0,0,0,0,47.1278,10980,0,11695,0
26.1401,0,0,53,0,9.744,51,8189,41,0,0,0,1057,6,727.313,11021,0,11748,0
20.4238,0,0,52,0,8.942,47,8191,31,0,0,0,840,1,104.471,11052,0,11800,0
46.7357,0,0,50,0,14.839,75,8191,50,0,0,0,1734,41,74.9782,11102,0,11850,0
0.418677,0,0,6,0,14.64,75,8191,6,0,0,0,4,4,74.9782,11108,0,11856,0
36.1874,0,0,103,0,12.284,63,8181,76,0,0,0,1365,23,1210.65,11184,0,11959,0
7.99952,0,0,63,0,7.095,38,8189,63,0,0,0,294,0,639.906,11247,0,12022,0
22.4929,0,0,19,0,11.019,57,8191,19,0,0,0,881,19,90.8078,11266,0,12041,0
28.6012,0,0,64,0,10.465,54,8189,50,0,0,0,1133,7,1720.3,11316,0,12105,0
39.1393,0,0,44,0,14.777,76,8187,44,0,0,0,1434,40,1996.61,11360,0,12149,0
11.8317,0,0,76,0,8.994,47,8189,76,0,0,0,448,0,550.531,11436,0,12225,0
23.1132,0,0,30,0,12.07,62,8187,30,0,0,0,832,26,483.38,11466,0,12255,0
29.0924,0,0,77,0,10.792,56,8189,31,0,0,0,1140,11,58.7292,11497,0,12332,0
24.6889,0,0,35,0,13.634,70,8181,35,0,0,0,893,31,47.8849,11532,0,12367,0
26.291,0,0,83,0,10.801,56,8189,83,0,0,0,995,11,43.1442,11615,0,12450,0
19.3395,0,0,28,0,13.115,67,8191,28,0,0,0,706,22,43.1442,11643,0,12478,0
20.2651,0,0,73,0,9.725,51,8189,73,0,0,0,789,5,52.4626,11716,0,12551,0
52.0048,0,0,82,0,15.456,79,8184,82,0,0,0,1832,73,38.9393,11798,0,12633,0
0,0,0,0,0,15.456,79,8184,0,0,0,0,0,0,38.9393,11798,0,12633,0
30.0728,0,0,102,0,11.666,61,8191,36,0,0,0,1151,21,41.5717,11834,0,12735,0
19.2344,0,0,64,0,8.553,48,8189,64,0,0,0,750,2,42.0959,11898,0,12799,0
55.4827,0,0,59,0,11.376,79,8189,59,0,0,0,2016,53,38.6481,11957,0,12858,0
3.05823,0,0,6,0,16.029,81,8179,6,0,0,0,123,6,38.8577,11963,0,12864,0
18.5798,0,0,90,0,10.383,53,8191,90,0,0,0,684,9,36.8426,12053,0,12954,0
11.5767,0,0,53,0,7.199,39,8189,53,0,0,0,452,0,33.5229,12106,0,13007,0
54.8102,0,0,43,0,14.792,75,8190,43,0,0,0,2074,39,78.9385,12149,0,13050,0
24.0319,0,0,39,0,16.461,85,8183,39,0,0,0,816,29,65.6132,12188,0,13089,0
26.8325,0,0,109,0,11.304,60,8178,109,0,0,0,963,21,35.9224,12297,0,13198,0
31.7817,0,0,45,0,12.239,76,8187,45,0,0,0,1130,41,32.7425,12342,0,13243,0
12.0187,0,0,77,0,9.172,48,8187,34,0,0,0,478,1,32.3581,12376,0,13320,0
2.43385,0,0,48,0,4.495,26,8189,33,0,0,0,76,0,32.2999,12409,0,13368,0
55.7942,0,0,42,0,13.596,70,8189,42,0,0,0,2171,38,894.555,12451,0,13410,0
34.944,0,0,56,0,16.915,86,8181,56,0,0,0,1187,48,64.9143,12507,0,13466,0
16.3741,0,0,94,0,16.926,54,8189,90,0,0,0,590,6,45.73,12597,0,13560,0
55.2382,0,0,73,0,16.787,82,8189,73,0,0,0,1969,63,42.1308,12670,0,13633,0
1.2917,0,0,7,0,16.139,83,8190,7,0,0,0,52,7,41.793,12677,0,13640,0
24.44,0,0,105,0,11.25,58,8189,84,0,0,0,903,17,427.412,12761,0,13745,0
21.814,0,0,62,0,9.506,50,8189,62,0,0,0,862,4,81.3613,12823,0,13807,0
15.4412,0,0,18,0,11.65,60,8191,18,0,0,0,576,17,47.3258,12841,0,13825,0
22.6054,0,0,65,0,9.574,51,8146,42,0,0,0,882,4,35.969,12883,0,13890,0
13.2445,0,0,15,0,11.799,59,8189,15,0,0,0,483,13,35.0372,12898,0,13905,0
23.8158,0,0,61,0,9.701,51,8189,61,0,0,0,945,2,49.3176,12959,0,13966,0
23.0755,0,0,35,0,13.004,66,8191,35,0,0,0,840,28,41.3853,12994,0,14001,0
27.1301,0,0,78,0,10.839,56,8189,78,0,0,0,1056,10,31.8806,13072,0,14079,0
0,0,0,0,0,10.839,56,8189,0,0,0,0,0,0,31.8806,13072,0,14079,0
40.1994,0,0,77,0,11.89,61,8189,77,0,0,0,1524,18,38.5316,13149,0,14156,0
19.4758,0,0,29,0,13.978,72,8183,29,0,0,0,725,23,361.239,13178,0,14185,0
23.2355,0,0,86,0,10.583,54,8190,86,0,0,0,886,12,89.8177,13264,0,14271,0
0,0,0,0,0,10.583,54,8191,0,0,0,0,0,0,89.8177,13264,0,14271,0
25.8592,0,0,64,0,10.005,52,8191,64,0,0,0,1034,8,38.252,13328,0,14335,0
17.2718,0,0,52,0,8.417,44,8189,52,0,0,0,695,0,41.5135,13380,0,14387,0
13.6453,0,0,19,0,10.605,55,8191,19,0,0,0,504,13,43.7266,13399,0,14406,0
35.2071,0,0,78,0,10.85,58,8175,51,0,0,0,1344,22,37.2037,13450,0,14484,0
55.9927,0,0,71,0,14.112,85,8189,70,0,0,0,1968,59,48.0247,13520,0,14555,0
11.038,0,0,22,0,17.495,89,8155,22,0,0,0,368,19,42.62,13542,0,14577,0
25.2855,0,0,101,0,11.967,61,8191,58,0,0,0,984,11,268.813,13600,0,14678,0
10.7952,0,0,61,0,7.593,40,8189,61,0,0,0,414,0,797.329,13661,0,14739,0
54.9495,0,0,60,0,14.679,75,8152,60,0,0,0,2027,50,1068.21,13721,0,14799,0
81.0597,0,0,35,0,11.107,87,8191,35,0,0,0,939,31,116.596,13756,0,14834,0
6.98684,0,0,87,0,8.883,47,8187,74,0,0,0,241,0,80.907,13830,0,14921,0
42.0534,0,0,41,0,14.199,72,8189,41,0,0,0,1511,37,1278.37,13871,0,14962,0
44.3202,0,0,72,0,17.864,91,8183,72,0,0,0,1519,65,43.0277,13943,0,15034,0
7.96534,0,0,95,0,8.497,49,8189,95,0,0,0,250,4,36.1554,14038,0,15129,0
24.5731,0,0,26,0,12.734,65,8187,26,0,0,0,936,23,745.472,14064,0,15155,0
25.422,0,0,77,0,9.74,54,8189,77,0,0,0,983,11,123.003,14141,0,15232,0
25.4708,0,0,34,0,13.495,69,8182,34,0,0,0,936,29,65.3569,14175,0,15266,0
26.157,0,0,77,0,10.389,55,8189,77,0,0,0,1014,5,69.3172,14252,0,15343,0
47.6715,0,0,71,0,15.665,80,8189,71,0,0,0,1693,61,53.0799,14323,0,15414,0
3.51706,0,0,80,0,8.205,41,8189,80,0,0,0,93,0,49.702,14403,0,15494,0
52.6642,0,0,46,0,14.984,75,8189,46,0,0,0,2024,40,820.508,14449,0,15540,0
0,0,0,0,0,14.984,75,8191,0,0,0,0,0,0,820.508,14449,0,15540,0
17.9858,0,0,83,0,9.937,51,8191,83,0,0,0,686,5,147.231,14532,0,15623,0
14.6641,0,0,52,0,7.838,41,8187,46,0,0,0,588,1,319.633,14578,0,15675,0
28.2042,0,0,27,0,11.841,62,8191,27,0,0,0,1056,24,54.2098,14605,0,15702,0
22.8576,0,0,69,0,7.516,51,8189,69,0,0,0,881,6,36.2136,14674,0,15771,0
22.3083,0,0,26,0,12.734,65,8187,26,0,0,0,819,23,40.2555,14700,0,15797,0
29.1383,0,0,78,0,10.662,56,8189,78,0,0,0,1092,11,32.8124,14778,0,15875,0
54.0649,0,0,69,0,19.74,84,8187,69,0,0,0,1965,59,209.361,14847,0,15944,0
0,0,0,0,0,19.74,84,8191,0,0,0,0,0,0,209.361,14847,0,15944,0
36.5481,0,0,113,0,11.267,65,8189,113,0,0,0,1334,24,35.1071,14960,0,16057,0
28.125,0,0,36,0,15.741,79,8172,36,0,0,0,1013,34,965.829,14996,0,16093,0
19.0694,0,0,87,0,10.367,54,8191,72,0,0,0,736,8,175.582,15068,0,16180,0
1.22174,0,0,54,0,6.129,20,8189,54,0,0,0,18,0,145.029,15122,0,16234,0
55.4616,0,0,38,0,11.131,70,8189,38,0,0,0,2146,31,59.3,15160,0,16272,0
16.1366,0,0,25,0,15.296,78,8189,25,0,0,0,578,19,44.4721,15185,0,16297,0
