SendRate(Mb/s),ReceiveRate(Mb/s),RecvPackets,Send Loss,Recv Loss,RTT(ms),CWnd,FlowWindow,Retrans,PktSndPeriod(us),SendACK,SendNAK,RecvACK,RecvNAK,EstimatedBandwidth(Mb/s),Retrans_Total, NAK_TotalSent,Total Send Loss,Total Recv Loss
0.000889012,0,0,0,0,100,2,8192,0,0,0,0,0,0,0.000448,0,0,0,0
8.94089,0,0,4,0,17.987,760,8181,2,0,0,0,9733,1,187.317,2,0,4,0
15.768,0,0,12,0,20.217,1305,8145,10,0,0,0,17582,10,69.5784,12,0,16,0
16.1608,0,0,42,0,14.523,1663,8189,38,0,0,0,16624,25,68.9633,50,0,58,0
14.7981,0,0,11,0,5.011,1952,8189,2,0,0,0,16316,11,18.9383,52,0,69,0
14.7416,0,0,3,0,27.01,2180,8189,0,0,0,0,14752,2,18.5378,52,0,72,0
15.7058,0,0,543,0,35.068,2391,8189,542,0,0,0,15073,15,31.2377,594,0,615,0
15.8893,0,0,694,0,6.445,2573,8189,692,0,0,0,14059,17,37.292,1286,0,1309,0
19.8353,0,0,6948,0,28.967,2682,8190,6645,0,0,0,8988,118,145.237,7931,0,8257,0
1.83587,0,0,484,0,20.933,2687,8189,773,0,0,0,428,27,167.922,8704,0,8741,0
7.50517,0,0,2687,0,33.667,696,8189,901,0,0,0,7593,0,146.006,9605,0,11428,0
8.77835,0,0,0,0,48.827,1041,8189,0,0,0,0,9362,0,160.424,9605,0,11428,0
5.46225,0,0,856,0,12.024,1165,8190,856,0,0,0,4265,20,164.494,10461,0,12284,0
7.16014,0,0,1165,0,14.993,690,8189,391,0,0,0,7468,0,185.471,10852,0,13449,0
20.2222,0,0,9877,0,17.2,1082,8189,9877,0,0,0,10857,96,161.818,20729,0,23326,0
19.6756,0,0,3190,0,35.045,1450,8189,3189,0,0,0,14564,111,122.931,23918,0,26516,0
10.1791,0,0,852,0,28.857,1607,8188,852,0,0,0,7511,159,193.668,24770,0,27368,0
5.61796,0,0,2210,0,11.025,526,8189,1296,0,0,0,4339,17,158.773,26066,0,29578,0
17.5001,0,0,7244,0,11.146,993,8189,7244,0,0,0,11081,86,49.7594,33310,0,36822,0
12.6226,0,0,5202,0,9.492,1174,8190,5202,0,0,0,6138,49,94.3604,38512,0,42024,0
0.897185,0,0,1174,0,8.633,205,8189,510,0,0,0,671,0,85.3776,39022,0,43198,0
7.62498,0,0,11,0,43.436,752,8189,11,0,0,0,8200,8,93.6808,39033,0,43209,0
7.57446,0,0,7,0,57.153,1038,8189,7,0,0,0,7999,4,84.9489,39040,0,43216,0
8.51496,0,0,9,0,61.893,1253,8189,8,0,0,0,7688,7,12.669,39048,0,43225,0
9.68306,0,0,22,0,27.573,1441,8189,22,0,0,0,7921,15,15.9434,39070,0,43247,0
3.08031,0,0,546,0,14.84,1473,8189,546,0,0,0,1441,76,52.6772,39616,0,43793,0
6.09201,0,0,1478,0,36.767,633,8187,375,0,0,0,6292,3,36.6164,39991,0,45271,0
7.59714,0,0,0,0,54.718,964,8189,0,0,0,0,8247,0,8.09133,39991,0,45271,0
8.18044,0,0,1,0,61.629,1196,8189,1,0,0,0,7823,1,78.689,39992,0,45272,0
8.90708,0,0,0,0,68.773,1383,8189,0,0,0,0,7556,0,148.176,39992,0,45272,0
3.11932,0,0,256,0,20.505,1447,8191,256,0,0,0,2820,39,156.471,40248,0,45528,0
3.70638,0,0,1508,0,29.211,443,8163,1045,0,0,0,3081,3,166.84,41293,0,47036,0
17.4833,0,0,8028,0,10.522,917,8189,8026,0,0,0,10098,94,127.701,49319,0,55064,0
9.633,0,0,3558,0,25.245,1093,8191,3558,0,0,0,5524,62,174.025,52877,0,58622,0
6.29859,0,0,1093,0,19.096,642,8189,584,0,0,0,6472,0,52.2126,53461,0,59715,0
10.5756,0,0,150,0,19.902,1063,8190,123,0,0,0,11201,56,64.3068,53584,0,59865,0
3.05571,0,0,1153,0,10.255,416,8189,296,0,0,0,2723,6,36.7302,53880,0,61018,0
15.9039,0,0,4289,0,20.335,926,8189,4289,0,0,0,10689,82,141.601,58169,0,65307,0
15.2056,0,0,2028,0,5.724,1311,8189,2028,0,0,0,13488,26,170.424,60197,0,67335,0
18.5851,0,0,6841,0,8.559,1526,8189,6792,0,0,0,9522,122,132.435,66989,0,74176,0
19.1692,0,0,8193,0,25.608,1711,8189,8192,0,0,0,9358,85,141.985,75181,0,82369,0
16.1825,0,0,7156,0,18.681,1853,8189,7156,0,0,0,7939,109,118.026,82337,0,89525,0
1.49022,0,0,1853,0,9.253,265,8189,898,0,0,0,1115,0,151.264,83235,0,91378,0
8.61861,0,0,0,0,3.017,832,8191,0,0,0,0,9717,0,167.576,83235,0,91378,0
9.01859,0,0,0,0,10.194,1154,8189,0,0,0,0,10007,0,162.329,83235,0,91378,0
9.08255,0,0,71,0,12.432,1395,8189,71,0,0,0,9592,15,38.7538,83306,0,91449,0
1.84624,0,0,508,0,11.192,1422,8189,508,0,0,0,1208,4,47.8343,83814,0,91957,0
12.2723,0,0,4664,0,13.635,731,8189,3702,0,0,0,8380,55,20.7818,87516,0,96621,0
18.2941,0,0,8324,0,14.492,1072,8189,8323,0,0,0,9593,131,141.803,95839,0,104945,0
9.5273,0,0,3717,0,6.58,1200,8191,3717,0,0,0,4559,42,137.549,99556,0,108662,0
6.09819,0,0,1203,0,10.366,641,8189,241,0,0,0,6442,1,182.712,99797,0,109865,0
13.3481,0,0,20,0,11.006,1155,8187,17,0,0,0,14448,17,56.633,99814,0,109885,0
18.0089,0,0,5968,0,7.205,1444,8187,5965,0,0,0,11703,66,93.7359,105779,0,115853,0
12.2559,0,0,4807,0,11.823,1570,8190,4800,0,0,0,5950,119,141.478,110579,0,120660,0
4.0017,0,0,1834,0,18.282,451,8189,1126,0,0,0,3195,8,58.955,111705,0,122494,0
13.5641,0,0,2009,0,8.11,986,8189,1959,0,0,0,12031,93,174.596,113664,0,124503,0
14.4986,0,0,2499,0,4.949,1348,8189,2473,0,0,0,13189,40,147.344,116137,0,127002,0
14.2588,0,0,27,0,36.725,1653,8187,2,0,0,0,14338,17,203.547,116139,0,127029,0
13.4309,0,0,86,0,7.003,1917,8189,83,0,0,0,14684,52,47.9705,116222,0,127115,0
14.3859,0,0,715,0,40.02,2132,8189,643,0,0,0,13636,140,27.9404,116865,0,127830,0
8.56477,0,0,72,0,5.709,2273,8143,72,0,0,0,9728,1,7.16083,116937,0,127902,0
4.33647,0,0,961,0,11.269,2315,8190,961,0,0,0,3006,6,9.44518,117898,0,128863,0
4.09312,0,0,2471,0,11.962,509,8189,208,0,0,0,4074,3,10.5517,118106,0,131334,0
9.04622,0,0,386,0,4.967,920,8189,386,0,0,0,9189,13,6.27558,118492,0,131720,0
8.91504,0,0,274,0,5.284,1188,8187,274,0,0,0,8820,23,5.66003,118766,0,131994,0
8.97545,0,0,325,0,2.955,1406,8189,325,0,0,0,8853,27,5.68333,119091,0,132319,0
8.88854,0,0,135,0,7.22,1602,8189,135,0,0,0,9222,9,5.60403,119226,0,132454,0
9.13542,0,0,684,0,9.686,1768,8187,684,0,0,0,8724,37,5.25011,119910,0,133138,0
9.0964,0,0,485,0,5.173,1923,8191,485,0,0,0,8930,19,6.16986,120395,0,133623,0
9.0476,0,0,362,0,13.722,2066,8191,362,0,0,0,8954,19,10.6104,120757,0,133985,0
9.26987,0,0,616,0,7.734,2195,8189,616,0,0,0,8592,27,5.42259,121373,0,134601,0
9.13602,0,0,349,0,2.966,2324,8189,349,0,0,0,9087,28,5.04358,121722,0,134950,0
8.87883,0,0,18,0,2.865,2456,8189,13,0,0,0,9876,11,117.864,121735,0,134968,0
9.00853,0,0,11,0,3.026,2583,8189,8,0,0,0,10004,10,149.701,121743,0,134979,0
9.0102,0,0,0,0,4.767,2705,8189,0,0,0,0,10039,0,134.559,121743,0,134979,0
9.30044,0,0,1778,0,17.289,2798,8189,1777,0,0,0,8037,25,40.26,123520,0,136757,0
8.73136,0,0,429,0,2.883,2905,8189,429,0,0,0,9481,6,18.4361,123949,0,137186,0
9.00609,0,0,423,0,14.327,3001,8189,423,0,0,0,8885,29,6.22586,124372,0,137609,0
9.00336,0,0,40,0,10.423,3105,8187,40,0,0,0,9928,3,6.65952,124412,0,137649,0
8.91918,0,0,458,0,3.318,3193,8189,457,0,0,0,8640,38,5.61971,124869,0,138107,0
8.88369,0,0,34,0,2.991,3289,8185,34,0,0,0,9792,22,7.7625,124903,0,138141,0
8.92395,0,0,326,0,7.855,3376,8189,326,0,0,0,8972,30,132.138,125229,0,138467,0
9.36509,0,0,2904,0,21.361,3444,8189,2904,0,0,0,7267,33,138.548,128133,0,141371,0
8.83033,0,0,1960,0,6.307,3519,8189,1960,0,0,0,8226,16,162.812,130093,0,143331,0
8.74054,0,0,344,0,2.979,3603,8187,340,0,0,0,9320,34,133.936,130433,0,143675,0
8.78042,0,0,1,0,11.346,3688,8189,0,0,0,0,9714,1,161.661,130433,0,143676,0
8.60051,0,0,102,0,3.331,3770,8189,92,0,0,0,9509,9,37.7624,130525,0,143778,0
9.10728,0,0,279,0,5.474,3846,8189,279,0,0,0,9057,17,6.94266,130804,0,144057,0
8.6284,0,0,156,0,13.45,3921,8189,144,0,0,0,9062,17,142.252,130948,0,144213,0
4.8598,0,0,1482,0,32.346,3941,8191,1482,0,0,0,2498,12,170.339,132430,0,145695,0
3.92639,0,0,4112,0,13.931,496,8094,439,0,0,0,3867,6,37.5321,132869,0,149807,0
8.83191,0,0,287,0,16.151,901,8189,333,0,0,0,8848,15,131.122,133202,0,150094,0
8.83239,0,0,181,0,11.919,1179,8189,181,0,0,0,9049,17,157.291,133383,0,150275,0
5.19488,0,0,756,0,60.055,1296,8191,755,0,0,0,4511,13,166.311,134138,0,151031,0
0.0788288,0,0,1296,0,3.803,60,8187,176,0,0,0,70,0,164.188,134314,0,152327,0
9.1561,0,0,19,0,15.136,800,8189,94,0,0,0,9953,15,29.353,134408,0,152346,0
9.402,0,0,188,0,2.986,1137,8189,188,0,0,0,10192,5,10.0769,134596,0,152534,0
9.57007,0,0,414,0,5.496,1383,8189,414,0,0,0,9693,17,135.858,135010,0,152948,0
4.554,0,0,803,0,11.646,1458,8191,803,0,0,0,3319,47,152.011,135813,0,153751,0
2.61844,0,0,1460,0,8.443,399,8191,573,0,0,0,2505,1,91.9085,136386,0,155211,0
5.84759,0,0,38,0,11.535,748,8174,38,0,0,0,6267,8,43.3337,136424,0,155249,0
7.4906,0,0,749,0,15.536,717,8191,123,0,0,0,8054,1,17.6978,136547,0,155998,0
11.0952,0,0,614,0,21.358,1108,8158,610,0,0,0,11144,36,67.9764,137157,0,156612,0
1.85531,0,0,1108,0,15.304,343,8187,104,0,0,0,1853,0,138.899,137261,0,157720,0
15.8306,0,0,648,0,14.861,1065,8189,647,0,0,0,15905,22,27.9736,137908,0,158368,0
11.3887,0,0,437,0,18.19,1344,8157,435,0,0,0,10485,120,58.2624,138343,0,158805,0
3.12061,0,0,1344,0,20.968,438,8189,526,0,0,0,3014,0,142.76,138869,0,160149,0
8.65219,0,0,0,0,46.362,892,8189,0,0,0,0,9432,0,169.516,138869,0,160149,0
9.26044,0,0,0,0,50.984,1173,8187,0,0,0,0,9070,0,174.495,138869,0,160149,0
7.43174,0,0,114,0,24.801,1362,8188,114,0,0,0,7508,30,197.04,138983,0,160263,0
5.56354,0,0,1456,0,11.535,593,8190,829,0,0,0,5516,17,83.5094,139812,0,161719,0
0.0752177,0,0,593,0,5.553,19,8185,120,0,0,0,17,0,77.4238,139932,0,162312,0
9.4369,0,0,1348,0,13.188,722,8191,1348,0,0,0,8147,43,113.659,141280,0,163660,0
2.30263,0,0,722,0,15.223,371,8143,455,0,0,0,2171,0,64.74,141735,0,164382,0
7.26448,0,0,145,0,12.25,798,8189,145,0,0,0,7795,28,72.7498,141880,0,164527,0
3.56823,0,0,798,0,26.718,485,8189,102,0,0,0,3696,0,24.9066,141982,0,165325,0
8.46503,0,0,0,0,46.467,909,8189,0,0,0,0,9237,0,8.26605,141982,0,165325,0
9.47068,0,0,170,0,56.056,1182,8189,170,0,0,0,8936,3,17.9191,142152,0,165495,0
7.30232,0,0,20,0,69.055,1341,8189,20,0,0,0,6260,14,15.0349,142172,0,165515,0
0.0702387,0,0,0,0,67.118,1341,8191,0,0,0,0,1,0,31.463,142172,0,165515,0
10.7192,0,0,3452,0,4.309,705,8187,2314,0,0,0,7796,46,116.078,144486,0,168967,0
10.6337,0,0,4369,0,13.17,968,8159,4368,0,0,0,6878,112,121.227,148854,0,173336,0
3.38823,0,0,1032,0,6.265,441,8189,391,0,0,0,3060,4,58.0182,149245,0,174368,0
4.90166,0,0,195,0,11.996,709,8173,195,0,0,0,4825,32,38.6664,149440,0,174563,0
9.1279,0,0,2552,0,5.438,710,8189,2088,0,0,0,7893,28,22.8579,151528,0,177115,0
20.3316,0,0,10067,0,18.837,1074,8190,9758,0,0,0,10175,106,58.3256,161286,0,187182,0
18.2821,0,0,1715,0,16.386,1492,8185,2014,0,0,0,16727,38,65.7247,163300,0,188897,0
9.45941,0,0,775,0,10.191,1672,8191,775,0,0,0,8938,47,33.535,164075,0,189672,0
5.42127,0,0,2284,0,12.53,542,8189,992,0,0,0,4619,12,156.957,165067,0,191956,0
18.3719,0,0,6590,0,18.886,1036,8187,6589,0,0,0,12195,76,169.617,171656,0,198546,0
19.3159,0,0,6831,0,45.664,1346,8189,6831,0,0,0,11532,66,183.301,178487,0,205377,0
13.5248,0,0,36,0,14.689,1649,8189,0,0,0,0,14190,27,219.332,178487,0,205413,0
13.8852,0,0,1028,0,4.792,1898,8189,1026,0,0,0,13806,53,208.54,179513,0,206441,0
13.2302,0,0,15,0,41.621,2125,8189,5,0,0,0,14256,10,51.8685,179518,0,206456,0
16.2069,0,0,4732,0,23.997,2300,8190,4494,0,0,0,12077,54,126.92,184012,0,211188,0
19.144,0,0,8238,0,6.142,2432,8187,8472,0,0,0,9799,86,182.065,192484,0,219426,0
5.44843,0,0,1563,0,13.279,2456,8186,1563,0,0,0,1830,45,166.035,194047,0,220989,0
5.12819,0,0,2460,0,32.53,574,8187,552,0,0,0,5168,2,126.728,194599,0,223449,0
7.45528,0,0,6,0,57.771,921,8189,6,0,0,0,8117,3,112.326,194605,0,223455,0
7.87007,0,0,16,0,64.192,1162,8189,16,0,0,0,7852,8,104.802,194621,0,223471,0
8.98821,0,0,829,0,28.802,1348,8189,829,0,0,0,7292,7,144.221,195450,0,224300,0
2.6181,0,0,721,0,10.416,1382,8191,721,0,0,0,1431,10,154.547,196171,0,225021,0
7.14626,0,0,1534,0,11.37,689,8190,362,0,0,0,7439,29,88.3228,196533,0,226555,0
1.02709,0,0,689,0,13.732,237,8189,293,0,0,0,894,0,123.486,196826,0,227244,0
8.71198,0,0,68,0,14.399,798,8189,68,0,0,0,9084,7,166.036,196894,0,227312,0
9.14191,0,0,145,0,13.659,1115,8189,144,0,0,0,9491,10,167.453,197038,0,227457,0
9.01592,0,0,1,0,2.876,1377,8189,0,0,0,0,10179,1,165.643,197038,0,227458,0
8.85665,0,0,308,0,11.927,1565,8190,308,0,0,0,8674,50,58.3614,197346,0,227766,0
1.34322,0,0,1565,0,4.951,243,8189,893,0,0,0,942,0,75.4168,198239,0,229331,0
8.10499,0,0,208,0,15.017,767,8191,208,0,0,0,8269,33,34.0932,198447,0,229539,0
1.30795,0,0,767,0,13.531,273,8191,308,0,0,0,1180,0,80.9451,198755,0,230306,0
10.8867,0,0,2288,0,13.264,793,8189,2288,0,0,0,8677,40,137.054,201043,0,232594,0
4.60267,0,0,153,0,20.373,957,8173,153,0,0,0,4473,30,174.467,201196,0,232747,0
5.56607,0,0,968,0,32.579,596,8189,175,0,0,0,5579,3,125.245,201371,0,233715,0
8.18997,0,0,7,0,52.221,961,8189,7,0,0,0,8889,4,29.6294,201378,0,233722,0
5.8578,0,0,416,0,9.708,1127,8191,416,0,0,0,5408,8,26.8061,201794,0,234138,0
4.62354,0,0,1127,0,10.613,549,8187,362,0,0,0,4723,0,153.843,202156,0,235265,0
2.66916,0,0,73,0,14.727,697,8191,73,0,0,0,2880,12,163.827,202229,0,235338,0
3.37477,0,0,698,0,4.913,486,8189,71,0,0,0,3712,1,188.242,202300,0,236036,0
9.03762,0,0,0,0,3.274,939,8187,0,0,0,0,10082,0,138.636,202300,0,236036,0
9.12653,0,0,1,0,2.95,1238,8189,0,0,0,0,10187,1,149.574,202300,0,236037,0
9.15774,0,0,0,0,11.621,1477,8189,0,0,0,0,10155,0,200.063,202300,0,236037,0
9.32754,0,0,14,0,2.984,1687,8189,14,0,0,0,10377,9,142.393,202314,0,236051,0
9.43725,0,0,133,0,2.963,1868,8189,133,0,0,0,10031,7,148.456,202447,0,236184,0
9.97777,0,0,1148,0,24.873,1993,8186,1148,0,0,0,7590,49,173.519,203595,0,237332,0
0.842862,0,0,1993,0,6.703,172,8187,830,0,0,0,477,0,178.831,204425,0,239325,0
9.63742,0,0,214,0,13.713,822,8190,214,0,0,0,10104,45,158.652,204639,0,239539,0
5.08518,0,0,822,0,12.029,587,8189,208,0,0,0,5404,0,186.054,204847,0,240361,0
6.3478,0,0,110,0,17.239,879,8172,110,0,0,0,6693,18,198.184,204957,0,240471,0
7.25452,0,0,879,0,10.672,703,8189,160,0,0,0,7752,0,180.023,205117,0,241350,0
1.98496,0,0,117,0,11.649,786,8001,117,0,0,0,1935,21,177.086,205234,0,241467,0
11.1762,0,0,807,0,8.174,877,8189,311,0,0,0,12039,16,178.014,205545,0,242274,0
11.486,0,0,1486,0,59.722,1170,8189,1486,0,0,0,9366,17,48.1811,207031,0,243760,0
10.8287,0,0,9,0,28.985,1409,8189,9,0,0,0,9644,6,80.614,207040,0,243769,0
3.61423,0,0,878,0,12.834,1454,8190,878,0,0,0,2031,10,137.053,207918,0,244647,0
5.91451,0,0,1456,0,35.34,629,8189,177,0,0,0,6197,1,18.7627,208095,0,246103,0
11.0679,0,0,213,0,11.018,1066,8189,209,0,0,0,11580,30,28.672,208304,0,246316,0
1.4313,0,0,133,0,13.938,1097,8089,133,0,0,0,1050,26,27.479,208437,0,246449,0
12.2274,0,0,2966,0,11.236,834,8189,2182,0,0,0,10901,59,58.8596,210619,0,249415,0
13.0867,0,0,2962,0,17.337,1147,8189,2961,0,0,0,9686,74,120.12,213580,0,252377,0
1.20232,0,0,1147,0,6.56,243,8189,593,0,0,0,939,0,166.573,214173,0,253524,0
16.7241,0,0,2671,0,17.004,1015,8147,2671,0,0,0,15175,79,170.047,216844,0,256195,0
0.596183,0,0,1015,0,6.815,166,8189,294,0,0,0,445,0,173.965,217138,0,257210,0
8.30672,0,0,4,0,39.934,774,8189,4,0,0,0,8945,2,145.816,217142,0,257214,0
6.06133,0,0,1208,0,22.168,977,8189,1208,0,0,0,5556,10,129.327,218350,0,258422,0
4.10273,0,0,1124,0,7.907,509,8189,460,0,0,0,4062,2,62.8593,218810,0,259546,0
3.57667,0,0,131,0,11.778,695,8191,131,0,0,0,3503,22,43.1478,218941,0,259677,0
3.4865,0,0,853,0,8.353,432,8189,518,0,0,0,2937,8,152.349,219459,0,260530,0
17.6087,0,0,5725,0,21.267,987,8189,5725,0,0,0,12310,78,50.4134,225184,0,266255,0
3.88136,0,0,352,0,14.371,1095,8171,352,0,0,0,3525,49,79.7117,225536,0,266607,0
12.284,0,0,1178,0,23.985,899,8189,281,0,0,0,12664,23,137.683,225817,0,267785,0
12.6981,0,0,2398,0,13.684,1211,8189,2398,0,0,0,10274,81,85.8059,228215,0,270183,0
2.88423,0,0,1211,0,12.068,429,8189,246,0,0,0,2900,0,56.2374,228461,0,271394,0
14.5334,0,0,625,0,24.582,1036,8187,610,0,0,0,13897,24,27.3956,229071,0,272019,0
9.68919,0,0,174,0,23.185,1311,8189,174,0,0,0,10096,25,78.2813,229245,0,272193,0
4.39482,0,0,1653,0,4.08,496,8191,549,0,0,0,3863,11,36.5452,229794,0,273846,0
18.3956,0,0,7609,0,8.882,971,8189,7609,0,0,0,10906,102,53.6265,237403,0,281455,0
16.2579,0,0,42,0,30.193,1411,8163,32,0,0,0,16354,13,177.544,237435,0,281497,0
0.295567,0,0,1411,0,8.644,83,8189,342,0,0,0,122,0,182.731,237777,0,282908,0
8.22553,0,0,132,0,42.906,742,8189,132,0,0,0,8506,4,31.8492,237909,0,283040,0
8.18175,0,0,49,0,54.066,1052,8189,49,0,0,0,8699,16,5.92659,237958,0,283089,0
8.46345,0,0,422,0,16.503,1269,8189,422,0,0,0,7850,12,27.798,238380,0,283511,0
0.573786,0,0,1269,0,6.87,95,8135,929,0,0,0,154,0,76.8351,239309,0,284780,0
8.84812,0,0,63,0,42.722,769,8189,63,0,0,0,9119,9,11.7627,239372,0,284843,0
8.25076,0,0,13,0,56.05,1076,8189,13,0,0,0,8832,9,114.934,239385,0,284856,0
9.50157,0,0,19,0,17.087,1303,8189,19,0,0,0,8472,4,137.799,239404,0,284875,0
1.27768,0,0,520,0,10.87,1314,8189,520,0,0,0,443,22,147.625,239924,0,285395,0
11.5295,0,0,1346,0,4.591,878,8189,315,0,0,0,12076,2,25.708,240239,0,286741,0
9.21319,0,0,161,0,21.658,1172,8189,161,0,0,0,9415,61,43.6271,240400,0,286902,0
3.42938,0,0,1173,0,27.766,473,8189,161,0,0,0,3517,1,109.711,240561,0,288075,0
7.35808,0,0,0,0,52.584,858,8189,0,0,0,0,8021,0,109.951,240561,0,288075,0
7.78808,0,0,0,0,60.725,1115,8189,0,0,0,0,7902,0,117.526,240561,0,288075,0
4.25681,0,0,924,0,7.902,1200,8189,923,0,0,0,3096,20,140.623,241484,0,288999,0
8.02537,0,0,2825,0,8.82,620,8189,1904,0,0,0,6022,36,154.097,243388,0,291824,0
14.4363,0,0,2906,0,5.819,1089,8189,2904,0,0,0,12548,37,193.878,246292,0,294730,0
15.9653,0,0,16,0,10.553,1491,8189,16,0,0,0,16207,9,201.127,246308,0,294746,0
16.7405,0,0,0,0,10.008,1823,8189,0,0,0,0,17218,0,191.49,246308,0,294746,0
8.8118,0,0,774,0,18.076,1967,8187,774,0,0,0,8480,45,183.338,247082,0,295520,0
5.38423,0,0,2560,0,23.02,517,8190,1488,0,0,0,4202,15,177.231,248570,0,298080,0
18.3068,0,0,9056,0,14.827,950,8189,9109,0,0,0,9916,100,144.657,257679,0,307136,0
10.8781,0,0,3069,0,11.748,1180,8189,3068,0,0,0,7664,110,74.3496,260747,0,310205,0
4.98573,0,0,1180,0,17.091,561,8189,698,0,0,0,4946,0,172.4,261445,0,311385,0
18.534,0,0,6248,0,6.381,1066,8189,6248,0,0,0,12829,71,111.934,267693,0,317633,0
8.09872,0,0,3760,0,24.612,1188,8160,3760,0,0,0,4307,57,112.822,271453,0,321393,0
7.08957,0,0,2400,0,3.829,582,8187,1544,0,0,0,5312,27,168.563,272997,0,323793,0
11.2596,0,0,2530,0,11.883,954,8191,2525,0,0,0,8936,67,96.7662,275522,0,326323,0
3.47472,0,0,1065,0,18.412,434,8191,388,0,0,0,2959,5,53.0289,275910,0,327388,0
15.6915,0,0,6326,0,8.083,876,8189,6326,0,0,0,9044,88,28.1702,282236,0,333714,0
5.14424,0,0,2781,0,12.546,962,8182,2781,0,0,0,2478,28,49.0793,285017,0,336495,0
5.42863,0,0,977,0,29.17,599,8189,330,0,0,0,5630,10,79.7718,285347,0,337472,0
10.1265,0,0,1922,0,6.986,938,8189,1922,0,0,0,8155,36,130.527,287269,0,339394,0
18.3059,0,0,6875,0,5.833,1241,8189,6875,0,0,0,10291,79,170.246,294144,0,346269,0
14.0385,0,0,1608,0,35.819,1507,8189,1606,0,0,0,11425,22,207.485,295750,0,347877,0
7.97255,0,0,313,0,22.685,1649,8154,284,0,0,0,7005,80,207.627,296034,0,348190,0
4.32875,0,0,1714,0,6.652,516,8189,272,0,0,0,4174,3,197.421,296306,0,349904,0
18.4938,0,0,7787,0,6.402,993,8189,7787,0,0,0,11273,82,83.1492,304093,0,357691,0
16.4311,0,0,144,0,17.458,1448,8187,144,0,0,0,17344,4,200.265,304237,0,357835,0
4.65071,0,0,1455,0,13.056,1510,8187,1455,0,0,0,2868,16,188.355,305692,0,359290,0
8.81641,0,0,3328,0,4.732,636,8187,2359,0,0,0,6348,37,143.649,308051,0,362618,0
19.3747,0,0,8498,0,12.272,1038,8187,8496,0,0,0,10514,102,64.0501,316547,0,371116,0
6.17212,0,0,2679,0,12.118,1126,8190,2679,0,0,0,2989,31,99.8664,319226,0,373795,0
9.6456,0,0,1134,0,18.308,808,8189,301,0,0,0,10222,5,123.635,319527,0,374929,0
10.1037,0,0,1126,0,30.793,1138,8191,1126,0,0,0,10026,43,125.758,320653,0,376055,0
0.0465493,0,0,1138,0,22.781,6,8189,104,0,0,0,4,0,137.343,320757,0,377193,0
13.3262,0,0,245,0,15.825,945,8189,424,0,0,0,13987,77,172.893,321181,0,377438,0
1.76373,0,0,945,0,5.246,306,8189,696,0,0,0,1481,0,194.945,321877,0,378383,0
4.67588,0,0,101,0,11.597,644,8189,101,0,0,0,5013,17,197.469,321978,0,378484,0
7.6115,0,0,719,0,12.204,716,8190,188,0,0,0,8034,17,59.4492,322166,0,379203,0
0,0,0,0,0,12.204,716,8191,0,0,0,0,0,0,59.4492,322166,0,379203,0
6.87052,0,0,876,0,31.9,645,8185,621,0,0,0,6531,10,35.1841,322787,0,380079,0
17.0319,0,0,5059,0,17.866,1103,8190,5059,0,0,0,12499,53,107.526,327846,0,385138,0
0,0,0,0,0,17.866,1103,8190,0,0,0,0,0,0,107.526,327846,0,385138,0
13.5287,0,0,4169,0,12.462,809,8189,3613,0,0,0,10251,70,174.363,331459,0,389307,0
0.00715636,0,0,809,0,12.462,2,8189,16,0,0,0,0,0,174.363,331475,0,390116,0
15.7433,0,0,4158,0,21.403,892,8189,4405,0,0,0,12467,46,69.6093,335880,0,394274,0
3.07584,0,0,1194,0,18.305,963,8187,1194,0,0,0,2050,36,67.803,337074,0,395468,0
6.4945,0,0,968,0,34.344,657,8189,304,0,0,0,6769,3,77.5663,337378,0,396436,0
9.36078,0,0,272,0,17.536,1012,8189,272,0,0,0,9247,5,138.435,337650,0,396708,0
9.69387,0,0,3884,0,16.943,1165,8140,3871,0,0,0,5215,95,173.729,341521,0,400592,0
7.86832,0,0,1506,0,12.08,710,8187,365,0,0,0,7906,15,203.442,341886,0,402098,0
9.71527,0,0,521,0,16.233,1032,8188,521,0,0,0,8749,95,194.54,342407,0,402619,0
3.63132,0,0,1032,0,3.433,504,8189,101,0,0,0,3982,0,97.2563,342508,0,403651,0
8.36528,0,0,2,0,3.669,917,8187,2,0,0,0,9170,1,147.405,342510,0,403653,0
8.22556,0,0,0,0,3.053,1195,8189,0,0,0,0,9191,0,140.749,342510,0,403653,0
8.43959,0,0,514,0,4.81,1414,8187,485,0,0,0,8921,42,168.324,342995,0,404167,0
8.4492,0,0,0,0,6.163,1613,8189,0,0,0,0,9411,0,165.413,342995,0,404167,0
8.57494,0,0,189,0,3.027,1787,8187,188,0,0,0,9253,11,130.182,343183,0,404356,0
8.59483,0,0,53,0,10.32,1946,8189,53,0,0,0,9293,4,153.306,343236,0,404409,0
8.61386,0,0,75,0,3.352,2094,8189,75,0,0,0,9329,5,161.784,343311,0,404484,0
8.43721,0,0,44,0,3.448,2228,8189,44,0,0,0,9055,4,153.268,343355,0,404528,0
8.5861,0,0,4,0,5.606,2361,8189,4,0,0,0,9557,3,149.852,343359,0,404532,0
8.49862,0,0,1,0,10.155,2486,8187,0,0,0,0,9430,1,156.264,343359,0,404533,0
8.66266,0,0,21,0,6.887,2603,8191,21,0,0,0,9353,4,167.703,343380,0,404554,0
8.76688,0,0,1848,0,3.665,2699,8189,1848,0,0,0,7917,15,144.697,345228,0,406402,0
2.84523,0,0,1413,0,70.411,2713,8191,1413,0,0,0,1159,5,157.261,346641,0,407815,0
2.14234,0,0,2713,0,19.859,372,8189,50,0,0,0,2186,0,131.452,346691,0,410528,0
8.10008,0,0,0,0,45.473,838,8189,0,0,0,0,8807,0,110.438,346691,0,410528,0
10.1955,0,0,491,0,11.252,1156,8191,491,0,0,0,9918,33,34.3495,347182,0,411019,0
0.0796703,0,0,2,0,11.252,1156,8191,2,0,0,0,0,1,34.3495,347184,0,411021,0
12.133,0,0,4525,0,17.768,724,8191,3541,0,0,0,8215,59,143.931,350725,0,415546,0
20.8519,0,0,11933,0,14.359,1081,8189,11933,0,0,0,10079,125,134.592,362658,0,427479,0
9.42448,0,0,3024,0,18.585,1242,8189,3015,0,0,0,5859,130,103.081,365673,0,430503,0
5.92176,0,0,2037,0,10.739,544,8191,1061,0,0,0,4653,20,31.5105,366734,0,432540,0
8.43349,0,0,708,0,52.354,889,8189,708,0,0,0,7718,16,5.54669,367442,0,433248,0
7.84917,0,0,17,0,59.612,1135,8187,17,0,0,0,7770,10,107.718,367459,0,433265,0
7.24768,0,0,1267,0,12.782,1285,8190,1267,0,0,0,5695,11,89.6412,368726,0,434532,0
1.55113,0,0,1285,0,14.731,290,8189,546,0,0,0,1328,0,160.381,369272,0,435817,0
5.3982,0,0,72,0,13.959,675,8189,70,0,0,0,5811,16,187.15,369342,0,435889,0
8.99969,0,0,675,0,32.051,776,8175,511,0,0,0,9422,0,194.207,369853,0,436564,0
4.17543,0,0,457,0,17.769,900,8191,457,0,0,0,3272,36,187.074,370310,0,437021,0
9.81043,0,0,902,0,15.933,818,8187,108,0,0,0,10489,2,190.799,370418,0,437923,0
10.7695,0,0,2,0,2.945,1207,8189,1,0,0,0,12322,2,19.2067,370419,0,437925,0
8.57378,0,0,0,0,3.133,1439,8187,0,0,0,0,9570,0,5.39795,370419,0,437925,0
8.50467,0,0,23,0,3.386,1635,8187,23,0,0,0,9447,14,141.191,370442,0,437948,0
8.48625,0,0,24,0,2.877,1810,8189,24,0,0,0,9418,12,138.796,370466,0,437972,0
8.52946,0,0,1,0,3.083,1970,8189,0,0,0,0,9426,1,137.504,370466,0,437973,0
8.50011,0,0,11,0,7.497,2116,8187,11,0,0,0,9354,3,150.675,370477,0,437984,0
8.4688,0,0,0,0,4.037,2255,8191,0,0,0,0,9478,0,158.379,370477,0,437984,0
8.51453,0,0,64,0,7.548,2383,8189,64,0,0,0,9263,4,158.026,370541,0,438048,0
8.52809,0,0,6,0,6.306,2507,8191,6,0,0,0,9517,5,161.042,370547,0,438054,0
