SendRate(Mb/s),ReceiveRate(Mb/s),RecvPackets,Send Loss,Recv Loss,RTT(ms),CWnd,FlowWindow,Retrans,PktSndPeriod(us),SendACK,SendNAK,RecvACK,RecvNAK,EstimatedBandwidth(Mb/s),Retrans_Total, NAK_TotalSent,Total Send Loss,Total Recv Loss
0.193928,0,0,1,0,38.381,6895,8190,1,33308.8,0,0,17,1,5.04931,1,0,1,0
0.417436,0,0,0,0,4.106,24,8187,0,8770.23,0,0,42,0,5.68754,1,0,1,0
0.998694,0,0,0,0,3.581,17,8187,0,4586.69,0,0,52,0,5.82874,1,0,1,0
1.60746,0,0,0,0,3.596,18,8183,0,3105.38,0,0,52,0,6.94139,1,0,1,0
21.439,0,0,216,0,10.048,9797,8191,216,291,0,0,46,154,1141.48,217,0,217,0
30.1073,0,0,4950,0,14.142,15642,8077,1086,96.6619,0,0,23,78,2031.65,1303,0,5167,0
46.188,0,0,3135,0,16.414,16818,8163,597,237,0,0,28,348,2604.21,1900,0,8302,0
49.1184,0,0,4164,0,14.094,14737,8180,3765,97,0,0,21,703,1618.21,5665,0,12466,0
66.6191,0,0,6801,0,19.897,22343,8115,6801,44.4319,0,0,13,284,2182.95,12466,0,19267,0
41.144,0,0,9231,0,19.875,17094,8191,7056,72.9672,0,0,10,621,1823.42,19522,0,28498,0
46.8423,0,0,8614,0,13.592,18777,8044,6685,34.8025,0,0,22,255,1691.54,26207,0,37112,0
59.7423,0,0,10790,0,27.579,29501,8001,3380,71.7703,0,0,6,1488,1161.22,29587,0,47902,0
49.1285,0,0,8449,0,31.937,33895,7926,7585,126,0,0,5,169,1315.91,37172,0,56351,0
65.4309,0,0,1045,0,15.721,18850,8182,8722,50,0,0,19,591,3024.6,45894,0,57396,0
58.1735,0,0,8935,0,26.136,24715,8189,8251,86,0,0,10,428,2000.57,54145,0,66331,0
50.3223,0,0,8621,0,37.027,27712,8185,6234,268,0,0,6,267,1387.99,60379,0,74952,0
74.1707,0,0,9835,0,24.339,26391,8160,7588,84,0,0,21,1026,2577.8,67967,0,84787,0
48.073,0,0,8676,0,37.732,33132,8171,7066,171,0,0,10,299,2239.66,75033,0,93463,0
53.5141,0,0,7771,0,21.092,21534,8096,7119,45,0,0,14,34,2339.02,82152,0,101234,0
44.5994,0,0,8934,0,17.907,21046,8055,6638,80.5368,0,0,11,458,1899.99,88790,0,110168,0
44.2579,0,0,7871,0,8.378,10907,8055,4901,43.8515,0,0,21,259,1740.49,93691,0,118039,0
46.1245,0,0,9962,0,11.331,10952,8089,2376,252.229,0,0,6,1102,792.369,96067,0,128001,0
63.0735,0,0,1504,0,7.959,12705,8121,7056,97,0,0,17,858,2320.8,103123,0,129505,0
54.2552,0,0,8448,0,14.356,17473,8043,8304,151,0,0,10,197,1438.71,111427,0,137953,0
58.7644,0,0,9234,0,10.445,12837,8054,5046,63,0,0,32,691,2821.07,116473,0,147187,0
38.4043,0,0,9706,0,19.189,19286,8069,4097,47.7381,0,0,16,949,2210.87,120570,0,156893,0
88.0695,0,0,7913,0,19.316,18783,8191,13429,61,0,0,1,344,1935.49,133999,0,164806,0
49.7375,0,0,8379,0,34.589,26912,8144,8084,73.4184,0,0,5,107,1352.75,142083,0,173185,0
49.5514,0,0,9390,0,17.856,18963,8159,4891,129,0,0,18,714,2185.89,146974,0,182575,0
55.2275,0,0,7155,0,13.367,15313,8165,6198,53,0,0,14,429,1642.21,153172,0,189730,0
42.5171,0,0,9259,0,10.617,13897,8073,5284,46.1113,0,0,23,622,1489.36,158456,0,198989,0
53.2464,0,0,9734,0,14.515,15714,8073,4837,86.5854,0,0,9,960,1436.91,163293,0,208723,0
48.676,0,0,228,0,14.109,16338,8084,6971,348,0,0,3,165,1960.59,170264,0,208951,0
73.4431,0,0,9864,0,13.267,15565,8191,6986,50,0,0,28,1026,1508.94,177250,0,218815,0
60.3049,0,0,8815,0,36.617,32614,8182,8506,69,0,0,7,342,1863.79,185756,0,227630,0
48.0377,0,0,8755,0,46.267,38484,7987,8509,64.4629,0,0,7,319,1040.69,194265,0,236385,0
46.9717,0,0,8101,0,40.277,27592,8078,7550,76.6387,0,0,6,79,1603.67,201815,0,244486,0
43.8681,0,0,9288,0,19.799,23401,8191,3571,201,0,0,13,734,2230.53,205386,0,253774,0
64.8202,0,0,5858,0,10.207,12088,8071,4851,88,0,0,24,604,2067.85,210237,0,259632,0
33.7661,0,0,9366,0,11.752,10053,8191,5174,73.874,0,0,20,734,1707.84,215411,0,268998,0
56.8923,0,0,4792,0,21.196,18298,8191,7438,283,0,0,13,224,1377.46,222849,0,273790,0
46.132,0,0,6179,0,19.003,15903,8173,2968,290,0,0,13,644,1868.21,225817,0,279969,0
66.0549,0,0,6418,0,16.536,16355,8147,6232,99,0,0,13,719,2510.33,232049,0,286387,0
41.2461,0,0,12852,0,15.93,19697,7983,7205,149,0,0,14,207,1584.09,239254,0,299239,0
46.7875,0,0,0,0,19.627,21007,8143,3566,123.283,0,0,7,0,2089.69,242820,0,299239,0
50.3242,0,0,10541,0,10.678,11925,8071,464,160,0,0,40,187,2314.91,243284,0,309780,0
36.1216,0,0,3749,0,11.733,14765,8167,2396,328,0,0,19,343,1835.01,245680,0,313529,0
49.0213,0,0,4322,0,17.265,18167,8169,3691,290,0,0,20,761,2032.38,249371,0,317851,0
68.8492,0,0,6399,0,15.673,17035,8071,6398,66,0,0,19,676,2455.39,255769,0,324250,0
47.8306,0,0,8620,0,19.319,21534,8003,8470,61.9136,0,0,6,307,1106.91,264239,0,332870,0
41.5683,0,0,8146,0,15.996,19375,8025,5693,90,0,0,36,96,2511.36,269932,0,341016,0
44.69,0,0,4434,0,14.803,16604,8154,2687,202,0,0,15,598,1865.97,272619,0,345450,0
64.4274,0,0,5439,0,11.205,12019,8191,5346,88,0,0,15,725,2001.1,277965,0,350889,0
33.55,0,0,8938,0,7.87,13155,8060,5173,45.0539,0,0,32,439,3002.52,283138,0,359827,0
53.3665,0,0,10009,0,10.349,15782,8075,3441,254.222,0,0,3,1118,2017.96,286579,0,369836,0
89.4337,0,0,8179,0,12.35,16572,8171,13475,62.2159,0,0,17,513,2028.98,300054,0,378015,0
54.2964,0,0,8171,0,34.652,30916,8102,9480,100.281,0,0,7,26,1750.38,309534,0,386186,0
36.5467,0,0,8326,0,11.958,15039,8135,926,180,0,0,25,161,2094.28,310460,0,394512,0
42.7876,0,0,3821,0,12.679,14820,8119,2147,302,0,0,21,566,2678.63,312607,0,398333,0
64.3446,0,0,5919,0,16.234,19358,8134,5663,141,0,0,16,854,2907.03,318270,0,404252,0
59.183,0,0,8482,0,13.388,17789,8126,6326,41.5658,0,0,16,198,2284.15,324596,0,412734,0
60.4976,0,0,9423,0,22.259,26681,8067,9160,48.3841,0,0,10,720,1043.32,333756,0,422157,0
45.8362,0,0,8067,0,22.259,26681,8067,8067,62,0,0,0,339,1043.32,341823,0,430224,0
66.9121,0,0,9015,0,50.742,39695,8026,8578,288,0,0,21,573,148.774,350401,0,439239,0
67.8949,0,0,7101,0,24.096,24332,8079,6199,97,0,0,18,764,1997.32,356600,0,446340,0
51.606,0,0,8536,0,10.312,15396,8131,6497,58,0,0,23,268,2651.76,363097,0,454876,0
35.4254,0,0,9798,0,9.26,13633,8025,4112,42.7641,0,0,17,969,2347.66,367209,0,464674,0
102.178,0,0,16352,0,9.546,14551,8176,16032,58,0,0,1,431,2403.33,383241,0,481026,0
43.0234,0,0,8537,0,24.783,24432,7320,6667,73.8916,0,0,3,197,1612.74,389908,0,489563,0
72.6994,0,0,5124,0,38.587,31224,7558,11475,142,0,0,5,165,1421.55,401383,0,494687,0
35.3507,0,0,7877,0,22.147,20563,8095,1796,250,0,0,18,307,1953.92,403179,0,502564,0
68.5478,0,0,5550,0,17.464,19142,8086,5537,282,0,0,13,1243,2776.79,408716,0,508114,0
51.5994,0,0,8706,0,12.866,14293,8191,6578,68,0,0,15,365,1667.35,415294,0,516820,0
42.3777,0,0,8889,0,12.508,16011,8144,6365,85.8441,0,0,16,388,2668.8,421659,0,525709,0
50.0596,0,0,8164,0,11.123,14034,7739,6609,34.397,0,0,22,99,2661.78,428268,0,533873,0
64.6965,0,0,10313,0,38.88,35461,8141,5491,48.5251,0,0,8,1237,1993.47,433759,0,544186,0
59.4848,0,0,9099,0,42.884,33636,8119,7911,53.9692,0,0,13,543,870.769,441670,0,553285,0
45.8383,0,0,8706,0,39.435,29872,8036,6220,110.515,0,0,7,341,385.798,447890,0,561991,0
81.6967,0,0,2185,0,18.384,20807,8071,8295,84,0,0,29,1267,2831.03,456185,0,564176,0
50.1536,0,0,8275,0,28.355,26694,8161,7902,96,0,0,8,119,1381.7,464087,0,572451,0
45.0643,0,0,8311,0,8.588,13190,8190,6697,41.1787,0,0,28,95,2914.45,470784,0,580762,0
55.2999,0,0,9841,0,19.844,19648,8094,6170,59.8591,0,0,11,936,1626.45,476954,0,590603,0
45.2163,0,0,8827,0,16.73,20999,8052,5620,47.4134,0,0,15,437,2693.42,482574,0,599430,0
102.339,0,0,15923,0,16.73,20999,8052,15499,61,0,0,0,510,2693.42,498073,0,615353,0
32.4811,0,0,8052,0,16.944,22525,7049,5763,76.8016,0,0,2,20,2063.94,503836,0,623405,0
48.315,0,0,7439,0,18.788,23527,7261,5625,249.68,0,0,8,229,2504.79,509461,0,630844,0
66.8165,0,0,2276,0,13.572,16155,7550,5631,108,0,0,13,1297,1575.76,515092,0,633120,0
45.8804,0,0,7621,0,17.402,14712,8191,6313,328,0,0,13,71,1748.33,521405,0,640741,0
70.811,0,0,8419,0,14.403,14286,8191,7391,36,0,0,19,618,2340.86,528796,0,649160,0
59.5251,0,0,9638,0,35.262,29620,8112,6870,75,0,0,6,829,1727.44,535666,0,658798,0
37.3756,0,0,8572,0,13.319,16575,8082,6307,82.7378,0,0,27,264,1516.82,541973,0,667370,0
53.486,0,0,6758,0,13.353,17839,8147,7415,33.7278,0,0,19,103,2141.63,549388,0,674128,0
61.1379,0,0,10016,0,29.454,29455,8191,5680,53.0302,0,0,6,1068,1302.37,555068,0,684144,0
53.5274,0,0,9297,0,31.57,27827,8143,6428,77.4336,0,0,9,641,1746.41,561496,0,693441,0
40.8343,0,0,153,0,31.57,27827,8143,6245,126,0,0,0,106,1746.41,567741,0,693594,0
74.8552,0,0,10138,0,13.24,17020,7787,7869,71,0,0,24,1140,2675.07,575610,0,703732,0
59.3193,0,0,8372,0,28.691,24106,7918,8034,238,0,0,10,368,1774.04,583644,0,712104,0
62.6223,0,0,16105,0,18.609,18037,8185,9333,77,0,0,16,69,2352.92,592977,0,728209,0
49.5079,0,0,554,0,23.317,21905,7942,7263,90,0,0,7,614,928.254,600240,0,728763,0
50.2243,0,0,8095,0,47.714,43338,8191,6190,256,0,0,9,126,1031.6,606430,0,736858,0
61.2224,0,0,9128,0,28.28,25663,7931,6716,369,0,0,11,825,2612.12,613146,0,745986,0
64.753,0,0,9543,0,10.079,16213,8144,5987,76,0,0,20,912,1711.31,619133,0,755529,0
41.5045,0,0,8541,0,14.825,17712,8078,7351,79.9405,0,0,12,224,2079.07,626484,0,764070,0
33.1631,0,0,8320,0,7.94,12859,8032,4273,46.77,0,0,24,169,2380.35,630757,0,772390,0
58.1998,0,0,9917,0,15.771,16382,7793,5500,82.5687,0,0,7,1008,1759.97,636257,0,782307,0
63.2773,0,0,5013,0,18.943,19192,8055,10686,105.716,0,0,8,35,1901.26,646943,0,787320,0
46.7213,0,0,8234,0,10.814,10135,8139,491,85,0,0,28,107,2260.95,647434,0,795554,0
76.1979,0,0,5200,0,16.024,16355,6534,5068,36,0,0,22,473,2588.82,652502,0,800754,0
39.3315,0,0,8553,0,35.996,32557,8096,6367,62.8696,0,0,7,1141,1948.54,658869,0,809307,0
35.5633,0,0,8838,0,20.259,21872,8124,3936,163.096,0,0,14,435,645.12,662805,0,818145,0
60.7689,0,0,1150,0,10.965,15821,8172,7555,158,0,0,12,666,2322.33,670360,0,819295,0
43.4396,0,0,8431,0,7.266,10715,8191,5609,348,0,0,29,182,2065.19,675969,0,827726,0
68.6696,0,0,6421,0,7.755,11524,8191,5952,130,0,0,13,1204,2428.3,681921,0,834147,0
47.7359,0,0,8692,0,10.383,8825,8191,6708,202,0,0,19,293,821.044,688629,0,842839,0
65.6326,0,0,7416,0,10.745,13263,8149,7114,51,0,0,17,251,2316.97,695743,0,850255,0
60.6584,0,0,8860,0,24.295,22106,8174,8776,60,0,0,10,404,1244.75,704519,0,859115,0
58.5388,0,0,9279,0,39.976,24385,8068,8115,74,0,0,7,624,1288.89,712634,0,868394,0
49.0737,0,0,8805,0,13.658,18089,8191,7098,37.6516,0,0,28,427,2062.35,719732,0,877199,0
56.2136,0,0,10099,0,20.134,25515,8061,5418,59.266,0,0,6,1099,931.525,725150,0,887298,0
41.7199,0,0,8325,0,19.445,21285,8088,6240,87.9561,0,0,9,164,1085.25,731390,0,895623,0
43.0833,0,0,8183,0,17.591,20462,7931,5260,233.865,0,0,3,95,1681.04,736650,0,903806,0
49.3047,0,0,3940,0,13.904,18276,8190,2448,98,0,0,24,426,2616.36,739098,0,907746,0
61.6764,0,0,4980,0,13.95,15434,8061,4966,80,0,0,13,823,2389.62,744064,0,912726,0
43.8588,0,0,9182,0,11.295,15380,8086,6439,45.678,0,0,18,645,2393.16,750503,0,921908,0
39.4509,0,0,9355,0,9.723,14926,8079,3090,194.563,0,0,13,738,2549.82,753593,0,931263,0
81.7904,0,0,12422,0,9.992,16071,7955,13200,66,0,0,11,96,2520.02,766793,0,943685,0
47.5127,0,0,8324,0,23.083,21446,7699,6691,145.951,0,0,5,454,1397.95,773484,0,952009,0
48.4368,0,0,563,0,8.584,12485,8139,3255,359,0,0,44,354,2493.72,776739,0,952572,0
63.679,0,0,5174,0,10.386,17132,8111,4915,166,0,0,22,1076,2336.02,781654,0,957746,0
62.0955,0,0,8457,0,12.166,13440,8115,7246,38.593,0,0,15,205,2371.44,788900,0,966203,0
58.3314,0,0,9115,0,23,23829,8191,9021,46.2962,0,0,9,571,1255.79,797921,0,975318,0
55.5573,0,0,8669,0,44.013,43667,8002,8362,54.0929,0,0,11,271,2257.95,806283,0,983987,0
73.045,0,0,9095,0,60.643,58629,7711,9095,240,0,0,8,1017,780.452,815378,0,993082,0
62.3176,0,0,8722,0,31.753,24454,8102,7564,51,0,0,18,493,2552.15,822942,0,1001804,0
66.0648,0,0,16372,0,31.114,25621,7865,10297,60,0,0,10,421,1747.97,833239,0,1018176,0
40.2569,0,0,8047,0,41.994,39416,8068,6965,97.9525,0,0,8,10,2468.88,840204,0,1026223,0
43.8559,0,0,5912,0,18.371,24407,6518,4764,116.142,0,0,17,104,2111.65,844968,0,1032135,0
42.3582,0,0,5021,0,14.2,16621,7939,2288,75.7958,0,0,27,502,1514.33,847256,0,1037156,0
58.5695,0,0,1751,0,12.441,17084,8146,4403,359,0,0,6,1016,1670.37,851659,0,1038907,0
59.3849,0,0,9333,0,14.591,19034,8134,7265,56,0,0,13,678,2129.43,858924,0,1048240,0
63.1283,0,0,16281,0,25.098,25458,8137,9576,95,0,0,12,335,952.795,868500,0,1064521,0
38.1552,0,0,8139,0,28.685,28059,8102,6713,107,0,0,1,2,1203.91,875213,0,1072660,0
80.2228,0,0,2411,0,30.312,28671,8099,7615,49,0,0,18,1387,1958.35,882828,0,1075071,0
56.035,0,0,8707,0,54.504,41712,8059,8268,60,0,0,7,346,1098.68,891096,0,1083778,0
52.1017,0,0,8379,0,57.861,51496,8049,8357,74,0,0,7,182,1488.15,899453,0,1092157,0
52.6741,0,0,8372,0,49.391,47723,8114,7816,147,0,0,6,207,673.117,907269,0,1100529,0
76.8225,0,0,10364,0,19.477,21749,8191,6507,56,0,0,25,1278,2715.93,913776,0,1110893,0
57.3625,0,0,15702,0,46.254,42931,8161,9986,108,0,0,8,231,1672.49,923762,0,1126595,0
39.2804,0,0,0,0,48.294,43476,8109,5678,105.716,0,0,2,0,1282.05,929440,0,1126595,0
60.4578,0,0,8494,0,25.475,26936,7527,8386,304,0,0,23,245,2806.19,937826,0,1135089,0
80.5322,0,0,8738,0,24.153,25645,8190,5347,56,0,0,19,1260,1877.32,943173,0,1143827,0
48.7455,0,0,8976,0,51.746,44985,8161,8632,63.7571,0,0,9,457,1757.83,951805,0,1152803,0
49.564,0,0,8514,0,45.196,41815,8179,7815,75.9549,0,0,6,196,794.956,959620,0,1161317,0
47.3653,0,0,8424,0,13.408,14637,8155,7219,52.2341,0,0,24,154,1449.9,966839,0,1169741,0
46.6337,0,0,7230,0,10.592,15722,8185,4685,40.7501,0,0,21,511,2519.49,971524,0,1176971,0
52.5612,0,0,10301,0,17.355,21061,8005,3574,107.938,0,0,8,1205,870.775,975098,0,1187272,0
62.2628,0,0,1484,0,12.423,12850,8104,6977,75,0,0,12,844,2816.67,982075,0,1188756,0
52.443,0,0,8417,0,15.01,13657,8164,8211,129,0,0,6,186,1971.44,990286,0,1197173,0
71.7557,0,0,9662,0,10.222,10986,8185,8554,124,0,0,23,864,2863.06,998840,0,1206835,0
45.0483,0,0,13025,0,8.529,14470,8126,7246,94,0,0,20,129,2538.51,1006086,0,1219860,0
42.729,0,0,7223,0,7.674,15367,8027,5236,70.3724,0,0,9,68,2346.04,1011322,0,1227083,0
53.3904,0,0,6764,0,26.011,23603,8056,4143,73.8834,0,0,15,858,1874.4,1015465,0,1233847,0
58.2864,0,0,9614,0,23.379,21004,8115,6165,160,0,0,6,879,1609.36,1021630,0,1243461,0
66.2882,0,0,1516,0,10.989,14836,8102,7587,121,0,0,19,882,2252.89,1029217,0,1244977,0
66.2648,0,0,9092,0,9.898,16820,8061,8579,76,0,0,20,548,2511.74,1037796,0,1254069,0
51.7239,0,0,8248,0,18.84,22578,8123,7641,96,0,0,11,115,1735.95,1045437,0,1262317,0
30.0631,0,0,8767,0,6.782,12364,8071,4817,46.8512,0,0,32,361,2572.4,1050254,0,1271084,0
50.4377,0,0,9028,0,9.706,16852,7966,4080,68.7477,0,0,9,869,1807.03,1054334,0,1280112,0
60.9554,0,0,8997,0,15.738,18978,8019,8063,71.5415,0,0,11,566,838.559,1062397,0,1289109,0
46.1557,0,0,8452,0,17.102,19945,7492,6766,350.758,0,0,5,195,670.689,1069163,0,1297561,0
66.9759,0,0,1993,0,10.003,14019,8063,6488,88,0,0,19,1155,2297.57,1075651,0,1299554,0
55.2798,0,0,8549,0,19.541,21995,8008,7974,124,0,0,10,281,2010.85,1083625,0,1308103,0
60.9341,0,0,8350,0,16.647,19924,8189,7528,51,0,0,28,192,2175.41,1091153,0,1316453,0
39.4538,0,0,9884,0,17.465,21111,7985,4903,48.9083,0,0,22,965,1886.79,1096056,0,1326337,0
64.4814,0,0,9430,0,21.39,21947,8030,7741,54.7445,0,0,11,763,2203.43,1103797,0,1335767,0
90.5626,0,0,15898,0,26.971,29524,8103,14298,68.0607,0,0,3,307,1688.64,1118095,0,1351665,0
46.4985,0,0,77,0,25.604,26798,8057,6121,348,0,0,23,142,3010.88,1124216,0,1351742,0
31.9929,0,0,7382,0,15.19,18274,8140,1751,329.697,0,0,27,268,2632.19,1125967,0,1359124,0
42.1018,0,0,3953,0,10.301,16844,7907,3958,59.0618,0,0,29,330,2504.08,1129925,0,1363077,0
59.1961,0,0,2312,0,10.23,17927,8120,4230,175,0,0,3,1337,2697.63,1134155,0,1365389,0
62.4774,0,0,9415,0,10.506,14495,8191,7540,111,0,0,16,740,2089.09,1141695,0,1374804,0
54.4106,0,0,8401,0,13.846,16139,8191,8099,246,0,0,16,151,2803.61,1149794,0,1383205,0
66.861,0,0,8998,0,10.588,14588,8191,6660,51,0,0,18,460,2945,1156454,0,1392203,0
60.0707,0,0,8995,0,25.238,27285,8191,8597,70,0,0,7,459,2446.71,1165051,0,1401198,0
50.2826,0,0,15255,0,37.178,38742,8191,8336,94,0,0,8,530,848.358,1173387,0,1416453,0
44.4258,0,0,7313,0,40.304,38696,7365,5588,340,0,0,5,103,1249.56,1178975,0,1423766,0
65.9587,0,0,2006,0,23.01,23844,8084,6170,99,0,0,14,1150,2805.05,1185145,0,1425772,0
44.3873,0,0,8345,0,18.917,19053,8162,5921,441,0,0,11,179,2022.79,1191066,0,1434117,0
72.5988,0,0,8366,0,12,16652,8137,6403,63,0,0,24,937,2558.18,1197469,0,1442483,0
54.2913,0,0,14824,0,29.372,29356,6120,9561,85,0,0,7,341,1579.79,1207030,0,1457307,0
27.2443,0,0,0,0,29.372,29356,6120,4829,85,0,0,0,0,1579.79,1211859,0,1457307,0
48.0634,0,0,6430,0,30.178,27611,8156,6395,288,0,0,8,208,1947.74,1218254,0,1463737,0
70.0323,0,0,10065,0,20.626,18535,8185,5224,122,0,0,20,1093,2149.43,1223478,0,1473802,0
45.406,0,0,8790,0,22.145,23024,8090,6242,40.7583,0,0,18,369,2469.75,1229720,0,1482592,0
49.1182,0,0,8547,0,22.9,21967,8120,7129,63.5913,0,0,5,271,1391.72,1236849,0,1491139,0
44.7029,0,0,8510,0,19.24,22056,7545,6808,94.3774,0,0,17,225,1787.23,1243657,0,1499649,0
52.0599,0,0,6091,0,14.834,17586,8025,5768,41.4143,0,0,20,299,2350.75,1249425,0,1505740,0
71.7874,0,0,2991,0,22.866,19818,8189,4559,75,0,0,5,1738,2172.25,1253984,0,1508731,0
51.0745,0,0,8372,0,46.231,35136,8132,8370,88,0,0,7,106,1413.76,1262354,0,1517103,0
53.326,0,0,8361,0,38.972,35085,8043,8114,166,0,0,7,154,1452.08,1270468,0,1525464,0
70.9265,0,0,9435,0,15.367,20360,8138,6894,43,0,0,22,772,2707.39,1277362,0,1534899,0
48.8935,0,0,14906,0,29.852,33835,7811,8209,53.0302,0,0,6,382,1976.11,1285571,0,1549805,0
69.4179,0,0,6692,0,42.139,48107,7877,11516,105.364,0,0,5,198,1443.78,1297087,0,1556497,0
42.9862,0,0,8153,0,23.921,23717,8167,1237,251,0,0,20,202,2657.98,1298324,0,1564650,0
33.9293,0,0,3777,0,17.411,19107,8023,1745,258,0,0,14,152,1973.23,1300069,0,1568427,0
41.8705,0,0,5273,0,16.033,15012,8095,1369,290,0,0,31,191,2731.18,1301438,0,1573700,0
39.6743,0,0,3527,0,13.173,15316,8170,1135,319,0,0,16,463,2452.54,1302573,0,1577227,0
60.3872,0,0,5695,0,13.349,17173,8178,5509,327,0,0,16,933,2490.47,1308082,0,1582922,0
65.2509,0,0,9305,0,12.161,16721,8167,7352,60,0,0,16,722,2702.3,1315434,0,1592227,0
64.7273,0,0,15359,0,17.657,21561,8132,11391,72,0,0,6,16,1539.35,1326825,0,1607586,0
49.8352,0,0,8470,0,15.321,19378,8013,7899,36.0023,0,0,21,194,2361.34,1334724,0,1616056,0
60.2692,0,0,10081,0,27.94,32770,8072,5335,64.5804,0,0,9,1106,1605.88,1340059,0,1626137,0
48.6119,0,0,8988,0,28.815,34188,8055,6001,143.288,0,0,3,534,1077.54,1346060,0,1635125,0
81.6133,0,0,1867,0,15.614,20402,7955,9263,41,0,0,33,1035,1629.59,1355323,0,1636992,0
56.1402,0,0,8571,0,45.838,48780,8011,8336,57,0,0,10,345,1464.19,1363659,0,1645563,0
66.5733,0,0,16084,0,57.844,47859,8073,10387,98,0,0,8,279,1260.36,1374046,0,1661647,0
39.9556,0,0,8073,0,43.272,41193,6871,7078,84.7164,0,0,9,0,908.119,1381124,0,1669720,0
52.8897,0,0,4961,0,17.04,16580,6791,5784,40.7603,0,0,16,65,2318.62,1386908,0,1674681,0
55.8039,0,0,3011,0,18.312,15634,8180,3011,158,0,0,1,1714,2029.72,1389919,0,1677692,0
88.3845,0,0,16277,0,17.793,20479,8097,13857,66,0,0,17,372,2241.5,1403776,0,1693969,0
34.9117,0,0,8097,0,19.282,22524,8185,6185,61.1562,0,0,8,0,2483.95,1409961,0,1702066,0
71.7662,0,0,7131,0,24.172,24576,7954,10824,176,0,0,3,304,1666.69,1420785,0,1709197,0
41.5405,0,0,9025,0,18.729,20049,8090,3394,302,0,0,14,642,2137.3,1424179,0,1718222,0
68.5614,0,0,6957,0,10.872,16943,8165,5920,68,0,0,16,847,2531.97,1430099,0,1725179,0
51.2584,0,0,8611,0,15.791,19225,7773,8494,65.3343,0,0,4,261,1486.75,1438593,0,1733790,0
44.8867,0,0,8243,0,18.748,23257,8103,6493,283,0,0,8,279,1322.49,1445086,0,1742033,0
55.1873,0,0,7985,0,11.011,15533,8191,5863,122,0,0,16,426,2557.43,1450949,0,1750018,0
51.8339,0,0,8841,0,9.453,12543,8178,6321,51.1904,0,0,11,375,2096.35,1457270,0,1758859,0
39.487,0,0,9502,0,7.705,12152,8069,4825,90.7709,0,0,25,762,1958.36,1462095,0,1768361,0
44.9859,0,0,5349,0,7.529,11779,8191,5962,39.1544,0,0,19,66,2037.68,1468057,0,1773710,0
63.7808,0,0,2467,0,10.579,12625,8191,4599,107,0,0,2,1420,1839.28,1472656,0,1776177,0
53.1094,0,0,8650,0,17.778,16536,8138,7175,304,0,0,17,269,2731.08,1479831,0,1784827,0
61.9625,0,0,8344,0,9.333,13833,8154,7405,138,0,0,15,678,2638.25,1487236,0,1793171,0
58.8584,0,0,9342,0,8.666,13116,8142,6215,146,0,0,23,678,1763.29,1493451,0,1802513,0
47.1914,0,0,8166,0,9.053,12269,8176,7042,38.835,0,0,16,251,2744.24,1500493,0,1810679,0
55.3531,0,0,9276,0,13.34,16825,8083,6766,40.5441,0,0,20,632,2548.54,1507259,0,1819955,0
60.1163,0,0,9134,0,16.108,21127,8049,7764,49.9229,0,0,5,596,1311.23,1515023,0,1829089,0
54.6116,0,0,8978,0,26.076,26393,8060,7122,65.2165,0,0,12,525,844.896,1522145,0,1838067,0
70.0664,0,0,6692,0,26.076,26393,8060,9590,175,0,0,0,448,844.896,1531735,0,1844759,0
63.3776,0,0,8789,0,13.336,15834,7999,5473,41,0,0,28,391,1200.08,1537208,0,1853548,0
43.0834,0,0,9554,0,30.276,26980,7890,7091,50.6381,0,0,9,890,1114.21,1544299,0,1863102,0
43.9913,0,0,8407,0,33.63,29438,8144,6147,79.4609,0,0,8,300,1191.31,1550446,0,1871509,0
40.3607,0,0,8473,0,25.204,25301,7887,5790,122.364,0,0,7,200,1020.3,1556236,0,1879982,0
73.8568,0,0,2621,0,12.568,15737,8138,5742,466,0,0,18,1510,2170.76,1561978,0,1882603,0
45.1298,0,0,8138,0,12.062,14541,8150,7509,38.5415,0,0,21,0,2273.61,1569487,0,1890741,0
47.9746,0,0,8934,0,19.364,16668,7956,6591,76.3079,0,0,7,455,902.437,1576078,0,1899675,0
42.6447,0,0,8298,0,11.058,11385,8173,5924,41.0768,0,0,23,207,3047.61,1582002,0,1907973,0
50.1347,0,0,9333,0,13.361,12861,8104,2511,154.844,0,0,9,1137,2938.28,1584513,0,1917306,0
82.5134,0,0,6083,0,11.111,14201,8051,12131,138,0,0,9,353,2790.99,1596644,0,1923389,0
38.9105,0,0,8522,0,7.312,11450,8139,5863,44.5362,0,0,29,271,2235.25,1602507,0,1931911,0
43.6273,0,0,10113,0,11.52,14526,7991,2683,174.694,0,0,9,1146,684.797,1605190,0,1942024,0
67.5136,0,0,1433,0,6.686,13174,8081,8023,98,0,0,23,820,2694.97,1613213,0,1943457,0
52.8856,0,0,8379,0,13.53,19565,8191,8008,188,0,0,12,180,2221.92,1621221,0,1951836,0
57.7727,0,0,9026,0,9.701,15456,8191,6255,89,0,0,14,472,2155.13,1627476,0,1960862,0
51.7357,0,0,8760,0,9.077,16651,8191,5969,44.7981,0,0,15,345,2356.03,1633445,0,1969622,0
40.6941,0,0,9736,0,10.422,14028,8191,5232,85.7685,0,0,13,881,2255.79,1638677,0,1979358,0
39.5267,0,0,8399,0,8.643,12894,8191,5086,77.9235,0,0,8,153,1858.12,1643763,0,1987757,0
83.8803,0,0,6221,0,8.212,14455,8191,11461,159,0,0,3,547,2024.28,1655224,0,1993978,0
21.3108,0,0,8454,0,4.427,9592,7980,3636,60.7964,0,0,39,153,1777.66,1658860,0,2002432,0
44.6267,0,0,6722,0,10.938,15846,8123,2461,195.412,0,0,17,769,2599.25,1661321,0,2009154,0
59.3269,0,0,1370,0,8.799,14702,8191,5760,340,0,0,9,795,2680.51,1667081,0,2010524,0
65.873,0,0,9432,0,13.044,17372,8189,8264,48,0,0,15,691,2991.44,1675345,0,2019956,0
76.2798,0,0,16309,0,26.729,30290,8120,12640,66,0,0,8,179,1034.68,1687985,0,2036265,0
20.5554,0,0,0,0,26.729,30290,8120,3642,66,0,0,0,0,1034.68,1691627,0,2036265,0
38.6872,0,0,12676,0,30.175,32946,8031,3414,97.1866,0,0,17,320,2536.13,1695041,0,2048941,0
68.31,0,0,2451,0,21.271,26515,7955,5384,85,0,0,9,1419,1768.89,1700425,0,2051392,0
52.9238,0,0,8432,0,25.882,26966,8065,7207,324,0,0,9,285,1450.45,1707632,0,2059824,0
65.0945,0,0,9089,0,18.596,22254,8140,8335,84,0,0,18,596,2507.99,1715967,0,2068913,0
44.0384,0,0,8140,0,29.635,34244,8172,7799,77.4908,0,0,6,0,1737.46,1723766,0,2077053,0
53.1049,0,0,9284,0,14.19,19057,7861,4405,98,0,0,19,660,2750.94,1728171,0,2086337,0
52.8951,0,0,7319,0,11.78,15562,8128,7106,40.886,0,0,18,463,2570.99,1735277,0,2093656,0
51.6305,0,0,9362,0,17.935,18723,8102,5753,69.6478,0,0,7,694,2136.43,1741030,0,2103018,0
43.7706,0,0,8435,0,11.478,13816,7913,6733,87.9355,0,0,20,199,1899.02,1747763,0,2111453,0
49.0783,0,0,1099,0,11.118,15824,8096,3440,324,0,0,4,641,2388.1,1751203,0,2112552,0
75.533,0,0,15827,0,13.529,16651,8110,10094,78.3408,0,0,21,595,1095.98,1761297,0,2128379,0
52.2104,0,0,7236,0,20.369,20701,8023,8914,146,0,0,1,49,1078.18,1770211,0,2135615,0
42.4449,0,0,7095,0,16.79,17148,8068,2957,168,0,0,23,23,1880.37,1773168,0,2142710,0
37.5353,0,0,6591,0,13.287,15359,8146,1094,288.507,0,0,21,410,2240.55,1774262,0,2149301,0
64.9904,0,0,2166,0,9.184,13885,8098,5225,369,0,0,12,1262,2429.16,1779487,0,2151467,0
58.6297,0,0,8969,0,9.257,15878,8061,7207,85,0,0,23,498,2673.35,1786694,0,2160436,0
66.1427,0,0,8560,0,12.379,16038,8097,8091,36.4345,0,0,21,282,2561.92,1794785,0,2168996,0
60.1139,0,0,9225,0,25.389,29106,8122,8922,44.0982,0,0,8,641,2181.73,1803707,0,2178221,0
39.5336,0,0,8751,0,38.578,41861,8054,7001,53.3507,0,0,7,360,2114.56,1810708,0,2186972,0
32.2655,0,0,8362,0,9.302,15054,8043,4419,123.83,0,0,28,188,1244.77,1815127,0,2195334,0
43.1108,0,0,630,0,6.827,12724,8131,3172,339,0,0,15,407,2351.13,1818299,0,2195964,0
65.046,0,0,7264,0,7.599,11361,8136,6359,71,0,0,13,886,2607.55,1824658,0,2203228,0
47.4303,0,0,8627,0,12.36,15804,8150,5683,358,0,0,7,304,1626.49,1830341,0,2211855,0
63.3752,0,0,8653,0,11.117,16401,8119,7890,98,0,0,17,604,2859.53,1838231,0,2220508,0
42.43,0,0,8119,0,18.631,22151,8024,7513,89.2531,0,0,6,0,1289.64,1845744,0,2228627,0
41.2869,0,0,8784,0,8.88,14898,7521,3405,146,0,0,20,468,2683.05,1849149,0,2237411,0
58.2434,0,0,4865,0,9.051,13107,8160,4727,53,0,0,22,528,2489.25,1853876,0,2242276,0
30.8761,0,0,9781,0,10.872,15670,8191,3838,106.535,0,0,20,923,2453.11,1857714,0,2252057,0
63.7138,0,0,1790,0,8.955,12954,8191,6410,211,0,0,10,1038,2943.09,1864124,0,2253847,0
61.3262,0,0,8993,0,7.683,11029,8043,8484,155,0,0,20,445,2546.78,1872608,0,2262840,0
65.7775,0,0,8265,0,11.312,15330,8105,7531,44,0,0,26,128,2707.19,1880139,0,2271105,0
59.9631,0,0,9392,0,27.437,22659,8068,8544,42.1453,0,0,6,733,2039.01,1888683,0,2280497,0
56.3786,0,0,16326,0,43.135,38770,7498,8667,49.7052,0,0,9,428,1480.32,1897350,0,2296823,0
73.1387,0,0,8048,0,52.734,50170,7913,11998,88,0,0,4,466,871.068,1909348,0,2304871,0
38.2493,0,0,7940,0,21.866,21553,8099,5603,107,0,0,22,26,1997.66,1914951,0,2312811,0
38.9975,0,0,2405,0,12.801,12104,8191,337,258,0,0,20,181,2294.82,1915288,0,2315216,0
